postId,l1,l2,l3,l4,l5,l6,processed,found,missed
4947,10,2,1,0,0,0,78,13,65
8215,21,3,4,0,0,0,156,28,128
0,0,0,0,0,0,0,0,0,0
11797,8,1,0,0,0,0,78,9,69
0,0,0,0,0,0,0,0,0,0
431,218,29,26,3,8,3,1986,287,1699
440,202,25,8,4,1,1,2124,241,1883
21,743,82,65,36,7,13,6714,946,5768
27,554,76,60,33,10,8,5328,741,4587
30,408,45,42,13,9,4,3708,521,3187
35,84,6,2,3,0,4,1074,99,975
37,136,26,14,14,6,7,1842,203,1639
3548,297,35,21,1,5,5,2928,364,2564
39,552,39,32,8,7,0,5004,638,4366
42,687,74,50,16,4,3,5928,834,5094
44,269,42,24,11,6,4,2940,356,2584
48,223,29,22,8,0,1,2370,283,2087
52,334,43,21,9,2,5,3306,414,2892
3647,198,20,12,4,1,1,2316,236,2080
250,195,25,7,3,3,1,2070,234,1836
59,483,74,42,17,4,11,4860,631,4229
5103,69,15,6,5,2,2,738,99,639
3591,201,23,22,5,2,4,2322,257,2065
63,622,45,40,23,3,3,5256,736,4520
65,100,4,3,0,0,0,1032,107,925
76,566,82,64,8,15,1,5076,736,4340
605,302,26,24,8,6,0,2538,366,2172
4779,17,2,3,0,0,0,144,22,122
650,273,53,37,30,5,6,3264,404,2860
4966,462,60,64,27,8,3,4746,624,4122
5427,6,3,2,0,0,0,54,11,43
382,434,38,23,9,5,1,4020,510,3510
243,0,0,1,0,0,0,42,1,41
8548,201,23,20,4,0,1,1986,249,1737
393,294,31,17,7,5,0,2826,354,2472
421,184,26,19,3,3,3,1866,238,1628
0,0,0,0,0,0,0,0,0,0
341,5,2,1,0,0,1,90,9,81
5367,249,38,13,4,14,4,2310,322,1988
359,191,24,13,0,4,2,1938,234,1704
3603,294,52,20,2,6,0,2784,374,2410
364,12,2,1,0,0,0,114,15,99
399,13,3,0,0,0,0,186,16,170
506,116,8,8,1,1,2,1362,136,1226
511,785,92,77,10,13,2,6804,979,5825
5992,377,36,25,6,3,0,3270,447,2823
3544,694,87,64,20,10,3,7062,878,6184
4558,19,2,1,0,0,0,138,22,116
1270,643,61,50,9,2,4,5952,769,5183
827,90,13,5,8,0,1,786,117,669
5340,7,2,2,0,0,0,84,11,73
748,86,8,9,1,0,0,1056,104,952
904,157,29,18,6,4,4,1572,218,1354
4445,270,35,16,3,1,5,2742,330,2412
787,1290,122,82,60,18,4,11448,1576,9872
4819,257,27,19,7,0,2,2364,312,2052
4887,18,2,0,0,0,0,132,20,112
802,13,0,0,0,0,0,90,13,77
812,94,8,5,3,0,1,936,111,825
848,290,55,45,16,14,3,3042,423,2619
4780,17,1,0,0,0,0,138,18,120
866,9,2,0,2,0,0,90,13,77
890,286,44,33,10,9,4,2832,386,2446
3459,286,53,36,9,3,7,2982,394,2588
911,5,1,0,0,1,0,54,7,47
1031,420,33,29,18,1,1,3366,502,2864
5031,90,11,12,4,1,2,1074,120,954
1064,89,14,13,7,0,3,1206,126,1080
1085,322,35,17,13,2,0,3204,389,2815
955,270,36,30,8,0,2,3024,346,2678
4919,634,118,57,24,8,8,6432,849,5583
977,76,12,5,1,4,2,1068,100,968
1037,4,0,0,0,0,0,36,4,32
1043,453,42,27,8,2,1,4494,533,3961
1049,22,1,2,2,1,0,174,28,146
1275,987,135,70,21,8,4,8634,1225,7409
1096,0,0,0,0,0,0,0,0,0
4809,9,3,2,2,0,0,102,16,86
1104,9,3,2,2,0,0,102,16,86
4811,1167,84,55,40,8,13,10386,1367,9019
5226,17,1,1,1,0,0,114,20,94
5218,13,1,1,0,1,0,120,16,104
5213,473,54,33,21,7,3,4680,591,4089
1178,419,34,15,3,0,0,3756,471,3285
1242,12,0,2,0,0,0,132,14,118
5252,253,17,19,4,2,2,2460,297,2163
1281,23,4,1,1,1,0,192,30,162
1286,19,1,1,0,0,1,168,22,146
1290,9,2,1,0,0,0,66,12,54
1294,225,38,21,16,5,6,2394,311,2083
1302,3,0,1,0,0,0,42,4,38
1329,106,13,7,4,1,0,1128,131,997
1350,170,23,9,8,3,5,1890,218,1672
1363,14,0,1,0,0,0,138,15,123
1382,304,30,25,9,8,1,2820,377,2443
1519,100,25,17,3,2,2,1236,149,1087
1433,170,34,16,7,1,1,1722,229,1493
7179,0,0,0,0,0,0,264,0,264
1594,186,18,11,3,1,1,1806,220,1586
4799,173,16,13,5,2,1,1482,210,1272
5284,12,0,0,0,0,0,114,12,102
5279,7,0,0,0,1,0,90,8,82
5270,691,81,60,16,11,3,7236,862,6374
1559,0,0,0,0,0,0,0,0,0
4768,96,9,9,3,1,2,954,120,834
1575,11,1,0,0,1,0,108,13,95
1586,415,31,25,3,8,0,4362,482,3880
1613,82,11,11,1,1,1,876,107,769
1620,6,0,0,0,0,0,72,6,66
1624,145,29,21,4,1,1,1554,201,1353
1634,164,19,11,4,1,0,1740,199,1541
1643,3,0,0,0,0,0,36,3,33
1753,20,3,3,0,1,0,186,27,159
4954,17,3,2,1,0,0,180,23,157
1692,50,8,7,5,0,1,558,71,487
5128,413,36,27,5,9,1,3996,491,3505
5141,278,27,18,3,2,0,2454,328,2126
1717,237,24,15,5,0,1,2448,282,2166
1725,16,2,1,1,0,0,144,20,124
1728,6,0,0,0,0,0,60,6,54
4487,906,70,64,31,15,6,8604,1092,7512
2778,76,11,4,9,1,0,948,101,847
1756,9,1,0,0,0,0,96,10,86
1885,650,65,31,8,22,0,5778,776,5002
5144,319,51,27,5,3,2,2970,407,2563
5146,8,2,1,0,0,0,84,11,73
5147,66,12,9,0,0,0,546,87,459
5149,224,18,10,2,4,1,2250,259,1991
5152,6,0,0,0,0,0,54,6,48
3740,294,39,29,3,6,1,2772,372,2400
3815,632,36,34,10,4,4,5934,720,5214
3742,349,67,43,20,7,13,3672,499,3173
3744,792,88,71,23,5,4,8214,983,7231
4752,318,41,24,11,5,0,3258,399,2859
3809,1052,109,57,38,13,7,10152,1276,8876
3738,458,38,31,10,4,5,4308,546,3762
1816,6,0,0,0,0,0,54,6,48
1819,8,0,0,0,0,0,60,8,52
3793,193,32,17,19,1,6,2016,268,1748
3772,11,2,1,0,0,0,144,14,130
3746,616,66,43,15,5,4,5934,749,5185
1822,5,0,0,0,0,0,72,5,67
1915,9,0,0,0,0,0,78,9,69
0,0,0,0,0,0,0,0,0,0
5094,320,37,29,6,5,0,2988,397,2591
5096,6,1,2,0,0,0,78,9,69
5097,204,24,18,6,4,0,1878,256,1622
5099,10,1,2,0,1,0,84,14,70
5105,245,26,21,6,2,1,2226,301,1925
1845,116,24,16,7,2,5,1536,170,1366
1856,5,1,0,0,0,0,60,6,54
5107,632,53,34,24,3,0,6006,746,5260
5046,399,47,25,17,7,1,3738,496,3242
1890,14,1,1,1,0,0,102,17,85
1894,14,3,2,0,0,0,114,19,95
1907,10,2,2,0,1,0,96,15,81
4795,6,2,1,0,1,0,90,10,80
1919,331,22,16,5,2,0,3090,376,2714
2416,15,0,1,1,1,0,114,18,96
1934,8,3,1,0,0,0,90,12,78
1938,5,0,0,0,0,0,42,5,37
4902,9,0,0,0,0,0,72,9,63
4908,14,2,3,0,0,0,132,19,113
4909,14,3,2,0,0,0,108,19,89
2419,14,2,1,0,1,1,144,19,125
5039,8,5,2,0,0,0,90,15,75
5030,3,2,1,1,0,0,66,7,59
5033,5,1,1,0,0,0,54,7,47
5035,11,1,0,0,0,0,132,12,120
5002,27,5,3,0,0,0,210,35,175
4911,8,0,0,0,0,0,84,8,76
1968,230,25,20,3,5,4,2400,287,2113
4996,1053,101,61,19,13,2,10140,1249,8891
0,0,0,0,0,0,0,0,0,0
4686,337,50,39,16,7,7,3540,456,3084
2100,7,3,4,1,0,0,96,15,81
1982,7,2,1,0,0,0,72,10,62
2120,9,0,0,0,1,1,102,11,91
4922,7,1,1,0,0,0,66,9,57
4924,11,0,0,1,0,1,90,13,77
4979,6,1,0,0,0,0,66,7,59
4927,327,48,38,19,12,2,3336,446,2890
4754,10,2,2,0,0,1,132,15,117
4944,5,0,0,0,0,0,54,5,49
4893,13,3,1,0,0,0,108,17,91
4899,25,0,0,1,0,0,180,26,154
4900,10,0,0,0,1,0,96,11,85
4897,19,1,1,0,0,0,150,21,129
2217,205,19,16,3,3,0,2280,246,2034
2103,6,2,2,0,0,0,78,10,68
4945,4,0,1,0,0,0,60,5,55
2107,694,115,67,11,32,9,6888,928,5960
3788,178,26,25,5,8,2,1722,244,1478
3755,256,19,13,8,0,6,2910,302,2608
2137,306,31,26,7,4,0,2898,374,2524
3587,534,47,36,21,5,1,4554,644,3910
4976,106,18,11,1,0,6,1218,142,1076
5079,162,25,21,5,0,3,1494,216,1278
2157,304,40,27,4,1,4,2904,380,2524
2161,6,2,0,0,0,0,60,8,52
2237,1,0,0,0,1,0,30,2,28
2241,8,0,1,0,0,0,72,9,63
2249,3,1,0,0,0,0,36,4,32
2298,435,73,41,2,1,6,3714,558,3156
3002,127,16,17,6,3,8,1482,177,1305
2985,5,0,0,0,0,0,48,5,43
2987,5,4,2,0,0,0,72,11,61
2991,4,1,1,0,0,0,54,6,48
2956,325,39,26,12,3,1,3180,406,2774
2961,7,2,1,1,0,0,72,11,61
2963,20,1,0,0,0,0,150,21,129
2971,14,0,0,0,0,0,126,14,112
2980,681,87,49,12,4,5,6840,838,6002
2342,1098,124,91,54,29,21,11214,1417,9797
3582,218,32,23,9,6,0,2160,288,1872
0,0,0,0,0,0,0,0,0,0
3594,359,46,30,14,6,7,3564,462,3102
3567,492,38,38,36,3,2,4722,609,4113
2429,10,0,2,0,0,0,90,12,78
4078,166,29,8,6,2,0,1758,211,1547
3080,136,14,10,4,1,1,1206,166,1040
2439,15,2,2,0,0,0,126,19,107
5323,425,28,21,7,4,0,4140,485,3655
3094,16,2,1,0,1,0,156,20,136
3076,11,0,0,0,0,0,90,11,79
5037,277,52,29,4,1,8,2604,371,2233
2467,359,39,25,12,5,1,3252,441,2811
2473,12,4,2,0,1,0,132,19,113
4000,16,2,1,0,0,0,144,19,125
2475,20,4,3,0,0,0,174,27,147
2482,24,4,3,0,1,0,240,32,208
2495,432,39,34,17,5,5,3984,532,3452
2499,8,1,1,0,1,0,90,11,79
4001,6,0,0,0,0,0,60,6,54
2501,15,1,1,0,1,0,120,18,102
2512,9,0,2,0,1,0,90,12,78
2524,275,38,27,17,4,5,2928,366,2562
8697,124,13,13,2,0,1,1128,153,975
2775,25,3,2,0,0,0,270,30,240
3422,482,48,25,11,5,2,4494,573,3921
2617,1115,128,91,30,38,10,11046,1412,9634
2642,230,21,17,6,4,2,2142,280,1862
3270,32,3,5,0,1,3,384,44,340
3614,700,80,46,21,18,9,8040,874,7166
2649,12,1,1,0,0,1,120,15,105
5320,540,68,40,15,1,0,5406,664,4742
3597,5,1,0,0,0,0,42,6,36
3601,84,9,5,1,1,0,1212,100,1112
3598,8,2,2,0,1,0,72,13,59
2667,11,0,1,1,0,0,108,13,95
4017,219,15,9,4,1,0,1926,248,1678
2690,941,127,93,27,8,7,10074,1203,8871
2938,326,63,40,24,12,14,3600,479,3121
2706,12,3,2,0,0,0,96,17,79
2716,10,2,1,0,0,0,102,13,89
2720,10,0,1,1,0,0,84,12,72
4060,270,30,23,6,4,1,2892,334,2558
3606,245,37,24,7,6,5,2592,324,2268
2784,470,51,32,10,7,4,4548,574,3974
0,0,0,0,0,0,0,0,0,0
3031,293,32,22,7,0,7,2748,361,2387
3041,18,0,0,0,0,0,144,18,126
3043,10,0,0,0,0,0,72,10,62
3453,228,17,7,5,2,1,2106,260,1846
3203,446,61,45,19,11,8,4188,590,3598
3230,126,11,10,5,1,0,1296,153,1143
3475,599,57,31,13,4,11,5868,715,5153
3497,188,9,5,6,0,0,1776,208,1568
4925,556,67,41,6,1,1,4752,672,4080
3410,182,38,20,17,2,9,2142,268,1874
3451,204,28,15,6,3,0,1980,256,1724
3466,213,28,18,10,5,1,2346,275,2071
3444,215,20,9,1,2,3,2310,250,2060
3446,551,61,37,16,11,9,5478,685,4793
3489,244,45,34,7,4,8,2622,342,2280
3555,306,22,23,2,7,0,3036,360,2676
3455,10,2,2,0,1,0,96,15,81
3456,14,0,0,1,0,0,108,15,93
3462,13,1,1,0,1,0,126,16,110
3464,215,19,15,5,0,2,2100,256,1844
3472,8,2,2,0,0,0,90,12,78
3640,228,15,15,15,2,1,2592,276,2316
3619,433,50,35,27,4,6,4188,555,3633
3599,52,5,6,1,1,1,768,66,702
3483,828,80,68,19,22,7,7656,1024,6632
3487,276,26,14,3,1,0,2388,320,2068
3520,188,20,13,2,0,0,1794,223,1571
3495,260,30,28,7,5,1,2484,331,2153
3529,161,34,19,3,5,6,1962,228,1734
3621,297,38,27,5,1,4,3264,372,2892
3501,17,2,1,0,0,0,114,20,94
3504,11,0,1,0,0,1,120,13,107
3510,8,1,2,0,1,0,126,12,114
3513,7,1,1,1,0,0,84,10,74
3516,2050,215,138,55,16,10,18552,2484,16068
3518,444,48,43,11,2,23,4236,571,3665
3523,393,42,42,14,6,5,4116,502,3614
3525,373,54,44,18,5,8,3708,502,3206
3527,288,32,19,7,9,5,2874,360,2514
3532,148,17,14,1,0,1,1542,181,1361
3537,934,95,61,8,11,5,9636,1114,8522
3546,106,7,6,0,1,0,1080,120,960
3623,476,63,42,12,8,4,4980,605,4375
3638,227,22,14,2,3,0,2064,268,1796
3645,207,43,24,12,2,6,2490,294,2196
3651,281,44,24,9,0,1,3270,359,2911
3672,146,5,5,2,1,1,1560,160,1400
3659,418,55,41,21,4,3,3846,542,3304
3663,127,21,10,2,2,0,1542,162,1380
3666,229,7,3,3,1,1,2418,244,2174
3679,665,95,62,22,13,16,6510,873,5637
3670,261,16,10,4,0,0,2646,291,2355
3688,112,13,10,4,4,1,1464,144,1320
3675,1440,175,120,51,15,5,12966,1806,11160
3677,49,4,3,1,1,0,654,58,596
3683,198,41,22,4,3,0,2214,268,1946
3690,10,0,0,0,0,0,132,10,122
3692,10,0,0,0,0,0,132,10,122
3697,144,10,16,1,2,1,1380,174,1206
3700,701,92,62,37,30,10,7188,932,6256
3705,4,0,1,0,0,0,54,5,49
3706,11,1,2,1,0,0,114,15,99
3709,234,47,34,8,0,2,2466,325,2141
3722,85,6,5,1,1,0,906,98,808
3724,196,22,14,6,0,4,1818,242,1576
3726,455,59,39,10,7,7,4956,577,4379
3729,567,53,32,9,5,5,5298,671,4627
3818,131,11,3,1,9,3,1326,158,1168
3848,125,9,7,0,2,1,1284,144,1140
3822,675,77,84,15,3,8,7386,862,6524
3824,120,3,2,4,0,0,1326,129,1197
3899,36,6,2,0,0,0,378,44,334
3859,596,76,38,16,8,2,5538,736,4802
3836,109,10,6,0,3,0,1116,128,988
3902,484,64,31,13,13,4,4974,609,4365
0,0,0,0,0,0,0,0,0,0
3842,731,39,33,7,14,1,6180,825,5355
3846,295,37,12,3,2,6,2598,355,2243
3878,308,42,25,3,5,2,2634,385,2249
3855,145,20,12,7,1,0,1434,185,1249
3863,1099,101,75,4,4,5,10446,1288,9158
6861,494,59,35,12,3,6,4752,609,4143
4005,97,5,4,0,0,0,996,106,890
3897,146,17,11,2,2,1,1590,179,1411
3910,87,9,0,9,0,0,1224,105,1119
0,0,0,0,0,0,0,0,0,0
3892,286,52,34,9,9,10,3336,400,2936
3894,436,53,38,13,10,0,3918,550,3368
3906,373,37,22,1,1,0,4248,434,3814
3908,173,19,13,2,8,2,1866,217,1649
0,0,0,0,0,0,0,0,0,0
0,0,0,0,0,0,0,0,0,0
0,0,0,0,0,0,0,0,0,0
3926,11,2,2,0,0,0,108,15,93
3927,13,2,1,1,0,0,126,17,109
3929,99,1,4,0,3,0,1110,107,1003
3931,557,82,67,26,9,4,5700,745,4955
3933,271,33,18,2,2,1,2448,327,2121
0,0,0,0,0,0,0,0,0,0
0,0,0,0,0,0,0,0,0,0
3958,365,29,29,3,1,1,3696,428,3268
3944,6,2,3,1,1,0,78,13,65
3947,14,1,1,0,0,0,156,16,140
3962,8,1,3,0,0,0,90,12,78
3969,16,1,1,0,0,0,150,18,132
0,0,0,0,0,0,0,0,0,0
0,0,0,0,0,0,0,0,0,0
3980,161,12,10,3,4,1,1668,191,1477
3982,153,14,8,5,2,2,1596,184,1412
4043,14,0,1,1,0,0,132,16,116
4015,37,4,1,0,1,0,342,43,299
4012,26,4,3,2,0,1,228,36,192
4009,22,4,3,0,0,0,174,29,145
4010,21,4,3,0,0,0,192,28,164
4011,26,4,3,2,0,1,228,36,192
3995,745,84,72,13,5,4,7140,923,6217
4024,21,4,3,0,0,0,156,28,128
4064,581,47,31,21,0,1,5220,681,4539
0,0,0,0,0,0,0,0,0,0
0,0,0,0,0,0,0,0,0,0
0,0,0,0,0,0,0,0,0,0
4036,251,36,13,7,1,1,2832,309,2523
4044,19,1,2,0,0,0,144,22,122
4051,14,0,0,0,0,0,132,14,118
4053,12,2,1,0,0,0,102,15,87
4056,542,73,51,16,9,6,5940,697,5243
4058,625,60,37,16,10,3,6630,751,5879
4067,230,24,18,5,11,5,2508,293,2215
4069,363,37,21,11,6,6,3648,444,3204
6413,261,37,26,19,4,3,3252,350,2902
4184,519,40,38,12,5,4,4758,618,4140
4098,286,29,20,18,5,5,3108,363,2745
4100,319,58,22,3,6,2,3498,410,3088
4103,732,89,62,17,4,7,8004,911,7093
4124,12,1,0,0,0,0,102,13,89
4125,23,5,4,1,0,0,180,33,147
4129,14,1,0,0,0,0,174,15,159
4131,10,0,0,0,0,0,96,10,86
4133,13,1,1,0,0,0,138,15,123
4134,6,0,0,0,0,0,78,6,72
4136,13,0,1,0,0,0,114,14,100
4147,19,3,2,0,1,0,192,25,167
4151,168,18,15,5,1,0,1638,207,1431
4271,44,5,1,2,1,0,384,53,331
0,0,0,0,0,0,0,0,0,0
4158,11,0,1,2,0,0,108,14,94
0,0,0,0,0,0,0,0,0,0
0,0,0,0,0,0,0,0,0,0
0,0,0,0,0,0,0,0,0,0
0,0,0,0,0,0,0,0,0,0
4217,320,47,21,7,4,4,3078,403,2675
4190,5,0,0,0,1,0,42,6,36
4281,884,80,68,17,6,11,8664,1066,7598
4284,390,48,34,24,5,4,3864,505,3359
4254,26,4,2,0,0,1,246,33,213
4255,15,2,1,1,0,1,186,20,166
4260,92,16,10,0,1,0,1158,119,1039
4269,409,45,28,7,4,0,4164,493,3671
4273,212,27,17,3,3,4,2250,266,1984
10374,261,32,20,8,1,4,2670,326,2344
4305,221,18,17,2,0,2,1998,260,1738
4307,8,0,0,1,0,0,60,9,51
4310,10,0,0,0,0,0,72,10,62
4311,2,0,0,0,0,0,24,2,22
4313,18,0,0,0,0,0,132,18,114
4316,6,0,0,0,0,0,54,6,48
4321,15,0,2,1,0,0,180,18,162
4325,11,0,0,1,0,0,108,12,96
4399,699,84,65,24,14,9,7494,895,6599
4327,13,3,3,0,0,0,132,19,113
4334,182,34,9,2,2,3,2034,232,1802
4443,403,50,27,9,6,5,3606,500,3106
4387,385,32,14,9,3,0,3684,443,3241
4397,6,0,1,0,0,0,60,7,53
4401,7,0,0,0,0,0,72,7,65
4403,7,0,0,0,1,0,60,8,52
4404,16,0,1,0,0,0,120,17,103
4406,4,1,1,0,0,0,30,6,24
4412,6,1,0,0,0,0,60,7,53
4414,2,1,0,0,0,0,42,3,39
4416,8,0,0,0,0,0,108,8,100
4417,9,1,1,0,1,0,72,12,60
4420,3,0,0,0,0,0,48,3,45
4421,3,0,0,0,0,0,48,3,45
4422,277,20,20,6,5,0,2466,328,2138
4483,212,32,18,5,5,0,2184,272,1912
4432,13,1,1,0,0,0,90,15,75
4433,10,0,0,0,0,0,90,10,80
4436,5,1,0,0,0,0,90,6,84
4440,12,0,1,0,0,0,90,13,77
4519,211,31,19,11,4,2,2538,278,2260
4476,81,14,10,3,2,1,936,111,825
4478,15,2,2,0,2,0,180,21,159
4480,8,3,3,0,0,0,90,14,76
4481,8,1,1,0,0,0,108,10,98
4482,8,1,1,0,0,0,102,10,92
4506,10,2,2,0,0,0,84,14,70
4508,6,1,0,0,0,0,66,7,59
4509,19,2,2,0,0,0,138,23,115
4516,9,1,1,0,0,0,78,11,67
4554,291,31,17,10,1,4,2712,354,2358
4524,163,18,11,1,2,1,1584,196,1388
4543,7,0,1,0,0,0,102,8,94
4548,6,1,0,0,0,0,84,7,77
4556,227,33,27,4,1,0,2394,292,2102
4595,216,14,18,4,0,1,2118,253,1865
4603,710,78,59,22,4,5,6816,878,5938
4605,11,2,1,0,1,0,96,15,81
4607,12,2,3,0,0,0,120,17,103
4609,9,3,2,0,0,0,72,14,58
4612,14,2,3,0,0,0,120,19,101
4613,8,0,0,0,0,0,54,8,46
4623,13,1,2,1,0,0,120,17,103
4626,6,1,2,1,0,0,66,10,56
4628,12,2,0,1,0,0,114,15,99
4630,13,0,0,0,1,0,108,14,94
4632,15,0,0,0,0,0,126,15,111
4635,465,45,37,16,7,2,4392,572,3820
4641,8,3,0,0,0,0,120,11,109
4646,12,2,0,0,0,0,108,14,94
4648,17,1,2,0,0,0,132,20,112
4649,349,75,45,19,15,7,4632,510,4122
4651,0,0,0,0,0,0,0,0,0
4668,13,1,0,0,0,0,120,14,106
4670,10,3,1,1,0,0,156,15,141
4673,2,2,1,0,0,0,60,5,55
4674,9,1,3,1,0,0,120,14,106
4677,9,2,0,3,2,1,138,17,121
4678,9,2,0,3,2,1,132,17,115
4750,216,29,13,2,6,1,2208,267,1941
4682,206,42,19,9,6,4,2292,286,2006
4734,7,2,1,0,0,0,60,10,50
4755,46,9,6,0,0,0,396,61,335
4735,20,4,1,0,0,0,168,25,143
4736,10,3,1,0,0,0,102,14,88
4737,158,31,13,2,9,0,1674,213,1461
4738,10,0,0,0,0,0,108,10,98
4740,14,2,1,0,0,0,108,17,91
4741,6,0,0,0,0,0,54,6,48
4745,16,1,2,0,0,1,150,20,130
4770,7,2,0,1,0,0,96,10,86
4772,13,0,0,0,0,0,114,13,101
4797,5,2,1,1,0,0,66,9,57
4801,14,2,1,2,0,0,114,19,95
4872,1887,208,168,33,16,9,17064,2321,14743
4813,11,1,0,0,0,0,96,12,84
4816,12,0,1,1,0,0,144,14,130
4817,10,3,3,1,0,0,102,17,85
4875,49,4,1,0,0,0,510,54,456
5923,463,46,33,9,5,4,4536,560,3976
6491,658,87,50,21,15,18,6636,849,5787
5547,120,23,15,0,0,0,1152,158,994
5596,345,33,16,15,1,0,3198,410,2788
5607,13,1,1,0,0,0,126,15,111
5625,18,0,0,0,0,0,156,18,138
5703,79,12,13,3,0,0,648,107,541
5802,79,2,3,0,0,0,726,84,642
5843,167,10,1,2,0,0,1788,180,1608
5856,1141,121,74,25,10,5,10554,1376,9178
5860,14,0,0,0,0,0,114,14,100
5861,10,1,0,0,1,0,114,12,102
5862,13,0,0,1,1,0,102,15,87
5885,273,51,23,23,6,10,3078,386,2692
5888,11,0,1,0,0,0,102,12,90
5918,9,5,4,1,1,2,120,22,98
5919,317,20,8,5,1,1,3288,352,2936
5922,3,1,1,1,0,0,30,6,24
5925,278,33,17,2,1,0,2436,331,2105
5927,17,6,1,0,0,0,156,24,132
5945,175,11,7,6,0,1,1662,200,1462
5947,692,59,40,20,2,0,6180,813,5367
5951,353,28,30,5,2,1,3186,419,2767
5955,199,19,16,4,0,0,2154,238,1916
5957,480,91,76,44,12,12,6210,715,5495
5959,5,2,0,0,0,0,54,7,47
5961,9,1,1,1,0,0,96,12,84
5962,9,2,0,1,1,1,132,14,118
5963,10,2,1,0,0,0,120,13,107
5964,10,2,1,0,0,0,120,13,107
5981,295,56,40,15,16,8,3678,430,3248
5983,173,24,16,2,1,2,1626,218,1408
5986,16,4,2,0,0,0,150,22,128
5995,22,1,0,1,0,0,186,24,162
6015,127,26,9,1,4,1,1260,168,1092
6018,422,66,38,24,2,8,4446,560,3886
6021,12,4,4,0,0,0,150,20,130
6408,215,21,17,13,5,2,2190,273,1917
6025,171,17,9,2,1,0,1746,200,1546
6027,2,0,0,1,0,0,36,3,33
6028,355,40,26,4,5,1,3150,431,2719
6030,10,2,1,0,0,0,102,13,89
6054,350,51,54,20,11,10,4116,496,3620
6056,9,1,0,0,1,0,108,11,97
6058,7,0,3,0,0,1,108,11,97
6063,801,116,53,14,10,11,8052,1005,7047
6066,11,2,1,0,1,1,114,16,98
6083,214,17,9,5,2,0,2226,247,1979
6087,297,46,26,13,3,3,3072,388,2684
6092,0,0,0,0,0,0,54,0,54
6114,146,16,7,4,0,0,1308,173,1135
6119,158,21,11,3,0,2,1770,195,1575
6121,380,52,37,19,3,8,4104,499,3605
6144,368,22,20,8,3,1,4044,422,3622
6147,201,28,22,1,0,1,1812,253,1559
6155,52,12,3,5,0,0,882,72,810
6157,38,6,5,2,1,0,432,52,380
6176,356,26,13,4,1,0,3678,400,3278
6178,174,14,17,3,5,1,1938,214,1724
6184,739,83,52,5,10,1,6996,890,6106
6204,67,8,2,3,0,1,876,81,795
6206,460,71,43,13,7,6,4596,600,3996
6208,5,1,0,0,0,0,54,6,48
6209,15,2,0,0,0,0,126,17,109
6230,413,76,60,14,2,10,4188,575,3613
6232,10,3,1,0,0,0,108,14,94
6233,10,3,1,0,0,0,108,14,94
6238,290,30,21,9,1,1,2622,352,2270
6240,13,2,1,0,0,0,120,16,104
6244,14,1,2,0,0,0,114,17,97
6245,34,2,1,0,0,0,312,37,275
6262,734,84,75,11,1,0,6234,905,5329
6264,271,43,24,4,3,7,3006,352,2654
6268,392,58,27,14,5,3,3990,499,3491
6272,4,1,0,1,0,0,84,6,78
6273,32,2,2,1,0,0,342,37,305
6292,55,7,5,4,0,0,672,71,601
6295,299,46,27,2,2,0,3138,376,2762
6298,154,18,15,3,4,0,1704,194,1510
6301,3,0,2,0,1,0,42,6,36
6302,12,1,0,1,0,0,102,14,88
6303,273,24,21,5,1,4,2460,328,2132
6305,701,76,29,13,12,12,7002,843,6159
6332,59,10,7,4,0,0,552,80,472
6334,549,72,32,19,11,10,5646,693,4953
6337,7,0,0,0,1,0,78,8,70
6338,12,1,2,0,1,0,120,16,104
6340,267,41,18,17,2,10,3108,355,2753
6343,7,1,0,0,0,0,102,8,94
6345,6,0,2,3,0,0,114,11,103
6348,9,1,0,0,0,0,96,10,86
6349,161,18,11,7,1,6,1608,204,1404
6354,293,45,31,10,1,4,2988,384,2604
6356,224,16,9,1,0,0,2082,250,1832
6360,3,0,0,0,0,0,36,3,33
6372,110,12,5,5,1,2,1224,135,1089
6375,20,3,2,0,0,0,168,25,143
0,0,0,0,0,0,0,0,0,0
0,0,0,0,0,0,0,0,0,0
6378,421,47,26,11,6,3,4056,514,3542
6380,20,3,2,0,0,0,180,25,155
6382,12,1,1,0,1,0,90,15,75
6383,366,44,19,11,7,5,3636,452,3184
6385,12,4,2,1,0,0,114,19,95
6386,5,0,0,1,0,0,60,6,54
6416,12,1,2,0,0,0,120,15,105
6418,5,0,0,2,0,0,84,7,77
6425,45,8,2,0,0,0,576,55,521
6444,10,0,0,0,0,0,72,10,62
6446,137,16,2,3,1,0,1398,159,1239
0,0,0,0,0,0,0,0,0,0
0,0,0,0,0,0,0,0,0,0
0,0,0,0,0,0,0,0,0,0
0,0,0,0,0,0,0,0,0,0
0,0,0,0,0,0,0,0,0,0
0,0,0,0,0,0,0,0,0,0
0,0,0,0,0,0,0,0,0,0
0,0,0,0,0,0,0,0,0,0
0,0,0,0,0,0,0,0,0,0
0,0,0,0,0,0,0,0,0,0
0,0,0,0,0,0,0,0,0,0
0,0,0,0,0,0,0,0,0,0
0,0,0,0,0,0,0,0,0,0
6496,16,0,0,1,0,0,132,17,115
6499,10,1,1,1,0,0,126,13,113
6518,16,0,0,0,0,0,120,16,104
6519,8,3,1,2,0,0,90,14,76
6527,79,11,9,7,8,1,846,115,731
6529,10,1,1,1,0,0,90,13,77
6530,231,21,20,4,0,0,2244,276,1968
6532,18,3,3,1,0,0,162,25,137
6533,9,1,2,0,0,0,72,12,60
6534,3,2,2,0,0,0,42,7,35
6535,339,50,35,6,5,3,3552,438,3114
6538,7,2,1,0,0,0,90,10,80
6544,182,31,31,6,11,6,2364,267,2097
6563,36,6,4,3,0,0,396,49,347
6565,6,2,0,0,0,0,90,8,82
8417,167,18,12,10,0,5,1932,212,1720
0,0,0,0,0,0,0,0,0,0
6611,223,43,24,11,7,3,2616,311,2305
6617,7,2,0,1,0,0,96,10,86
6619,100,14,8,12,1,0,1080,135,945
6636,304,33,22,8,1,1,3108,369,2739
6647,9,4,4,1,0,0,132,18,114
6650,251,47,34,13,4,3,2988,352,2636
6648,11,0,1,0,0,0,108,12,96
6652,4,2,1,1,0,0,72,8,64
6653,13,3,2,1,0,0,126,19,107
6654,16,5,1,0,0,0,150,22,128
6655,8,1,0,0,1,0,108,10,98
0,0,0,0,0,0,0,0,0,0
6678,179,18,6,5,2,0,1656,210,1446
6680,237,37,22,8,12,6,2598,322,2276
6693,124,5,9,3,2,1,1284,144,1140
6696,5,0,2,1,0,0,66,8,58
6697,0,0,1,0,0,0,12,1,11
6698,6,0,1,0,1,0,78,8,70
6702,15,1,0,0,0,0,132,16,116
6706,18,0,1,0,0,0,144,19,125
6707,9,0,0,0,0,0,102,9,93
6712,12,0,0,0,0,0,144,12,132
6714,16,0,0,0,1,0,114,17,97
6716,9,0,0,0,0,0,96,9,87
6717,10,1,0,0,0,0,90,11,79
6718,354,63,49,14,9,8,3906,497,3409
6720,10,0,0,0,0,0,84,10,74
0,0,0,0,0,0,0,0,0,0
0,0,0,0,0,0,0,0,0,0
0,0,0,0,0,0,0,0,0,0
0,0,0,0,0,0,0,0,0,0
0,0,0,0,0,0,0,0,0,0
0,0,0,0,0,0,0,0,0,0
0,0,0,0,0,0,0,0,0,0
0,0,0,0,0,0,0,0,0,0
0,0,0,0,0,0,0,0,0,0
0,0,0,0,0,0,0,0,0,0
0,0,0,0,0,0,0,0,0,0
0,0,0,0,0,0,0,0,0,0
0,0,0,0,0,0,0,0,0,0
0,0,0,0,0,0,0,0,0,0
0,0,0,0,0,0,0,0,0,0
6799,211,32,23,12,2,3,2304,283,2021
6802,73,6,7,2,1,5,828,94,734
6804,294,24,15,9,0,3,2712,345,2367
6808,200,19,9,6,1,1,2106,236,1870
6844,0,0,0,0,0,0,0,0,0
6846,5,0,2,1,0,0,54,8,46
6847,21,1,0,2,0,0,162,24,138
6858,0,0,0,0,0,0,24,0,24
6892,94,18,12,0,0,2,1068,126,942
6915,0,0,0,0,0,0,48,0,48
8442,236,21,16,14,1,1,2298,289,2009
6917,381,44,26,9,8,5,4044,473,3571
6920,12,1,1,0,1,0,108,15,93
6923,5,3,1,1,0,0,60,10,50
6959,113,14,12,10,0,1,1176,150,1026
6962,272,17,19,10,0,1,2514,319,2195
6964,14,1,1,1,0,0,108,17,91
6965,13,0,1,0,0,0,120,14,106
6966,0,0,0,0,0,0,30,0,30
6968,5,2,2,1,0,0,78,10,68
6970,1811,254,209,84,15,20,17970,2393,15577
6972,11,1,0,0,0,1,102,13,89
6973,11,3,2,0,0,0,138,16,122
6977,16,2,0,0,0,0,132,18,114
6979,9,1,2,1,0,0,90,13,77
6982,6,1,3,1,0,0,78,11,67
6983,5,2,0,0,1,0,90,8,82
6999,246,22,12,2,0,0,2934,282,2652
7015,130,26,35,13,6,12,1686,222,1464
7029,274,28,23,12,1,2,3330,340,2990
7031,7,0,0,0,0,0,60,7,53
7047,256,25,19,2,2,1,2328,305,2023
7049,14,1,2,1,0,0,120,18,102
7051,568,84,57,15,8,4,5856,736,5120
7053,12,3,1,0,0,0,108,16,92
7057,8,0,0,0,0,0,66,8,58
7083,721,99,40,23,9,7,6540,899,5641
7085,11,1,0,1,0,0,90,13,77
7086,4,1,0,0,1,0,48,6,42
7087,20,8,4,0,0,0,168,32,136
7089,279,51,19,3,3,0,2976,355,2621
7122,17,2,2,0,0,0,114,21,93
7125,14,3,0,1,0,0,144,18,126
7136,84,17,14,6,1,5,1002,127,875
7141,18,1,1,0,0,0,162,20,142
7142,16,2,1,1,0,0,126,20,106
7145,17,3,2,0,0,0,144,22,122
7146,13,4,5,1,0,0,102,23,79
7181,6,1,0,0,0,0,66,7,59
7189,421,61,40,10,7,2,4416,541,3875
7192,14,2,1,0,0,0,138,17,121
7197,7,0,0,0,0,0,60,7,53
0,0,0,0,0,0,0,0,0,0
0,0,0,0,0,0,0,0,0,0
0,0,0,0,0,0,0,0,0,0
0,0,0,0,0,0,0,0,0,0
0,0,0,0,0,0,0,0,0,0
0,0,0,0,0,0,0,0,0,0
0,0,0,0,0,0,0,0,0,0
0,0,0,0,0,0,0,0,0,0
0,0,0,0,0,0,0,0,0,0
7241,9,1,1,0,0,0,72,11,61
7242,283,35,25,9,1,4,2826,357,2469
7249,0,0,0,0,0,0,48,0,48
7251,51,11,4,0,1,0,504,67,437
7253,7,2,0,0,0,0,96,9,87
7271,819,119,83,13,14,19,8268,1067,7201
7273,16,3,2,0,0,0,132,21,111
7274,18,2,3,0,0,0,168,23,145
7275,8,1,0,0,1,0,96,10,86
7276,225,48,30,4,0,1,2076,308,1768
7278,519,72,54,24,16,9,6408,694,5714
7280,11,2,2,0,0,0,144,15,129
7281,11,3,1,1,0,0,126,16,110
7282,13,0,2,0,0,0,138,15,123
7283,188,27,20,7,4,1,2352,247,2105
7353,157,15,11,3,0,2,1512,188,1324
7371,218,27,21,5,9,4,2190,284,1906
7374,294,37,17,7,4,1,2934,360,2574
7376,12,0,0,0,0,0,84,12,72
7378,79,13,8,6,1,1,912,108,804
7380,745,94,81,20,12,8,8502,960,7542
7385,9,2,2,0,1,0,114,14,100
7388,11,0,1,1,0,0,132,13,119
7389,15,2,1,1,0,0,150,19,131
7436,226,33,10,3,3,4,2454,279,2175
7439,4,2,0,0,0,0,60,6,54
7440,232,15,15,6,0,4,2394,272,2122
7442,12,1,0,0,0,0,108,13,95
7452,322,27,23,15,1,1,3084,389,2695
7456,9,1,0,1,0,0,90,11,79
7479,124,20,11,1,3,1,1194,160,1034
7495,307,43,31,13,3,1,2856,398,2458
7497,6,3,1,2,0,0,96,12,84
7499,11,1,1,1,1,0,90,15,75
7500,14,3,1,1,0,0,132,19,113
7503,706,104,85,30,3,3,7194,931,6263
7505,9,0,0,3,0,0,102,12,90
7507,8,1,1,0,0,0,102,10,92
7509,196,23,17,6,0,1,2046,243,1803
7514,10,2,2,0,0,0,138,14,124
7518,4,0,0,0,0,0,30,4,26
7520,129,23,20,7,6,1,1710,186,1524
7522,11,3,2,0,0,0,126,16,110
7567,13,2,1,2,0,0,132,18,114
7570,9,0,1,0,0,0,90,10,80
7573,327,59,32,30,3,2,4008,453,3555
7576,286,58,44,22,5,8,3210,423,2787
7581,146,11,5,0,0,0,1440,162,1278
7583,4,0,0,0,0,0,24,4,20
7584,184,22,16,0,7,0,1530,229,1301
7587,5,0,1,0,0,0,54,6,48
8411,81,12,10,1,0,0,882,104,778
7628,168,21,16,1,2,1,1938,209,1729
7633,221,28,11,8,4,0,2340,272,2068
7635,10,1,0,0,0,0,84,11,73
7636,380,54,24,13,13,2,4212,486,3726
7638,3,0,0,0,0,0,30,3,27
7665,870,100,55,23,9,7,8634,1064,7570
7650,533,64,36,4,5,1,4884,643,4241
7663,152,9,6,1,0,0,1236,168,1068
7669,14,1,1,0,0,0,102,16,86
7670,15,3,3,0,0,0,144,21,123
7680,187,24,16,9,7,4,2154,247,1907
7701,335,59,33,17,4,6,3882,454,3428
7704,7,1,4,1,0,0,108,13,95
7706,9,4,2,0,0,0,90,15,75
7707,161,13,8,1,2,0,1668,185,1483
7718,6,0,1,0,0,0,60,7,53
7733,12,0,0,0,0,0,102,12,90
7735,19,1,0,0,1,2,156,23,133
7736,13,0,0,0,0,0,114,13,101
7743,147,31,16,0,0,0,1548,194,1354
7745,8,3,1,0,0,0,102,12,90
7746,4,0,0,0,0,0,36,4,32
7747,16,5,2,0,0,0,138,23,115
7748,9,3,1,0,0,0,90,13,77
7752,8,0,0,0,0,0,54,8,46
7753,11,1,1,0,0,0,120,13,107
7754,11,1,1,0,0,0,120,13,107
7755,274,49,40,2,0,0,2352,365,1987
7855,100,9,12,0,0,0,1206,121,1085
7857,44,9,6,2,0,0,450,61,389
7863,23,1,1,0,0,0,156,25,131
7868,128,18,15,10,4,0,1392,175,1217
7872,9,1,0,0,0,0,90,10,80
7875,9,1,0,0,0,0,144,10,134
7876,8,1,1,1,0,0,84,11,73
7877,8,2,3,1,0,0,102,14,88
7879,269,21,13,0,1,1,2796,305,2491
7887,5,0,0,0,0,0,48,5,43
7888,12,1,0,0,0,0,138,13,125
7897,628,107,75,32,8,19,6276,869,5407
7899,19,2,3,1,0,2,156,27,129
7901,17,3,1,2,0,0,156,23,133
7904,15,0,0,1,0,0,138,16,122
7908,307,22,23,8,2,5,3150,367,2783
7910,12,2,0,1,0,1,120,16,104
7913,309,32,28,10,8,6,3366,393,2973
7918,12,0,1,0,0,0,132,13,119
7934,366,65,36,12,2,6,4242,487,3755
7936,15,2,0,1,0,0,120,18,102
7937,8,0,1,0,0,0,84,9,75
7941,261,18,16,10,2,7,2802,314,2488
7944,2,0,0,0,0,0,18,2,16
7950,4,0,0,0,0,0,30,4,26
7951,116,15,11,4,3,2,1170,151,1019
7955,6,1,1,0,1,1,84,10,74
7956,9,4,1,0,0,0,90,14,76
7957,18,3,2,0,0,0,186,23,163
7972,139,25,14,12,4,1,1608,195,1413
7974,14,5,1,1,0,0,132,21,111
7976,16,4,2,0,0,0,126,22,104
7981,128,27,15,9,1,5,1590,185,1405
7984,337,28,20,4,1,4,3042,394,2648
7990,7,1,0,0,0,0,72,8,64
15061,185,9,14,2,0,2,1998,212,1786
0,0,0,0,0,0,0,0,0,0
8100,236,38,23,4,2,5,2376,308,2068
8106,9,0,0,0,0,0,72,9,63
8107,437,79,56,26,14,7,5550,619,4931
8110,7,1,2,1,2,0,138,13,125
8111,10,0,0,0,0,0,132,10,122
8115,9,3,1,0,0,1,144,14,130
8117,101,13,6,0,3,1,984,124,860
8119,382,37,39,22,5,9,4596,494,4102
8121,13,0,0,0,0,0,120,13,107
8123,16,2,2,5,0,1,174,26,148
8124,3,1,0,0,0,0,36,4,32
8125,236,37,15,10,4,3,2628,305,2323
8127,7,1,0,0,0,0,78,8,70
0,0,0,0,0,0,0,0,0,0
0,0,0,0,0,0,0,0,0,0
0,0,0,0,0,0,0,0,0,0
0,0,0,0,0,0,0,0,0,0
0,0,0,0,0,0,0,0,0,0
0,0,0,0,0,0,0,0,0,0
0,0,0,0,0,0,0,0,0,0
0,0,0,0,0,0,0,0,0,0
0,0,0,0,0,0,0,0,0,0
0,0,0,0,0,0,0,0,0,0
0,0,0,0,0,0,0,0,0,0
0,0,0,0,0,0,0,0,0,0
0,0,0,0,0,0,0,0,0,0
0,0,0,0,0,0,0,0,0,0
8162,485,56,39,17,3,0,4584,600,3984
8166,14,3,3,2,0,0,144,22,122
8167,109,11,7,1,2,0,978,130,848
8170,305,29,18,12,4,6,3246,374,2872
8174,9,1,0,0,0,0,132,10,122
8175,12,0,0,0,0,0,120,12,108
8178,567,88,66,22,8,1,6252,752,5500
8180,129,14,9,1,1,0,1062,154,908
8188,16,5,1,1,0,0,156,23,133
8190,10,0,0,0,0,0,66,10,56
8192,245,45,26,10,5,3,2820,334,2486
8196,13,1,0,1,0,0,132,15,117
8197,6,4,2,0,0,0,66,12,54
8206,434,31,32,10,12,1,4122,520,3602
0,0,0,0,0,0,0,0,0,0
8254,436,76,40,17,3,5,4062,577,3485
8256,12,2,1,0,0,0,102,15,87
8257,16,4,0,0,0,0,150,20,130
8258,274,52,28,11,4,3,2760,372,2388
8260,13,1,3,0,0,0,114,17,97
8263,14,1,0,0,0,1,150,16,134
8265,174,18,19,6,2,4,1974,223,1751
8267,6,0,0,0,0,0,48,6,42
14977,178,20,11,4,1,2,1842,216,1626
8284,179,24,19,15,4,3,1848,244,1604
8286,16,0,0,1,0,0,126,17,109
8289,12,0,1,1,0,0,132,14,118
8290,4,0,0,0,0,0,30,4,26
8291,169,34,10,6,2,4,1680,225,1455
8293,301,45,25,9,4,4,2628,388,2240
8295,18,2,1,2,0,0,138,23,115
8299,348,36,25,5,0,4,3600,418,3182
8304,4,0,0,0,0,0,36,4,32
8306,8,2,1,0,0,0,72,11,61
8307,118,21,14,13,0,4,1542,170,1372
8329,189,25,18,4,2,7,1746,245,1501
8332,340,24,19,1,2,5,3456,391,3065
8338,7,2,1,0,0,0,84,10,74
8341,12,0,0,0,0,0,84,12,72
8344,11,1,1,0,0,0,90,13,77
8345,293,17,15,1,1,0,2496,327,2169
8347,15,0,1,0,0,0,114,16,98
8349,457,73,57,16,6,4,4758,613,4145
8355,15,0,0,0,0,1,132,16,116
8358,9,1,1,0,0,0,90,11,79
8359,17,1,2,0,0,0,150,20,130
8361,9,0,0,0,0,0,72,9,63
0,0,0,0,0,0,0,0,0,0
0,0,0,0,0,0,0,0,0,0
8404,10,1,1,0,1,0,78,13,65
8406,13,2,1,0,0,1,108,17,91
8408,14,1,1,0,1,0,132,17,115
8409,16,0,0,1,0,0,126,17,109
0,0,0,0,0,0,0,0,0,0
0,0,0,0,0,0,0,0,0,0
0,0,0,0,0,0,0,0,0,0
0,0,0,0,0,0,0,0,0,0
0,0,0,0,0,0,0,0,0,0
0,0,0,0,0,0,0,0,0,0
8434,145,23,15,3,5,1,1542,192,1350
8436,11,2,1,0,1,0,126,15,111
8437,12,2,0,0,0,0,102,14,88
8438,266,25,18,5,0,3,2790,317,2473
8440,6,0,0,0,0,0,84,6,78
8444,7,0,0,0,0,0,78,7,71
8445,7,0,0,0,0,0,78,7,71
8446,7,0,0,0,0,0,72,7,65
8448,2,1,0,1,0,0,42,4,38
8449,13,0,0,1,0,0,90,14,76
8450,5,3,1,1,0,0,60,10,50
8458,347,31,18,5,5,2,3264,408,2856
8460,11,1,0,0,0,0,102,12,90
8461,9,0,0,0,0,0,72,9,63
0,0,0,0,0,0,0,0,0,0
0,0,0,0,0,0,0,0,0,0
0,0,0,0,0,0,0,0,0,0
0,0,0,0,0,0,0,0,0,0
0,0,0,0,0,0,0,0,0,0
0,0,0,0,0,0,0,0,0,0
8475,5,0,0,0,0,0,54,5,49
8476,9,3,2,1,0,0,78,15,63
8477,6,0,0,0,0,0,60,6,54
8481,6,0,1,0,0,0,48,7,41
8484,19,3,7,0,1,0,174,30,144
8485,14,0,2,0,0,1,126,17,109
8486,7,2,3,1,0,0,78,13,65
8490,9,2,3,0,0,0,90,14,76
8494,346,52,43,15,11,14,4200,481,3719
8498,8,2,1,0,0,0,84,11,73
8499,14,0,1,0,0,0,138,15,123
8500,387,29,21,21,0,6,3816,464,3352
8502,428,42,24,6,2,1,4188,503,3685
8515,16,2,1,0,0,0,132,19,113
8528,299,30,26,9,6,0,3264,370,2894
8531,3,1,2,0,0,0,48,6,42
8532,13,1,0,0,1,0,132,15,117
8533,255,32,37,5,3,1,2580,333,2247
8535,7,1,1,1,0,0,72,10,62
8536,5,1,3,0,0,0,84,9,75
8539,308,32,27,11,0,2,2886,380,2506
8541,5,2,1,0,0,0,90,8,82
8542,11,1,1,0,0,0,72,13,59
8544,7,0,0,0,0,0,72,7,65
8552,9,0,1,1,0,0,90,11,79
8554,161,4,20,6,2,1,1992,194,1798
8556,4,1,2,1,0,0,60,8,52
0,0,0,0,0,0,0,0,0,0
0,0,0,0,0,0,0,0,0,0
0,0,0,0,0,0,0,0,0,0
0,0,0,0,0,0,0,0,0,0
0,0,0,0,0,0,0,0,0,0
8570,326,16,11,0,3,0,2682,356,2326
8576,236,19,12,0,1,2,2316,270,2046
8578,112,31,15,3,1,2,1440,164,1276
8584,348,22,21,12,10,5,3654,418,3236
8590,9,0,1,0,0,0,84,10,74
8591,5,0,0,0,0,0,36,5,31
8596,12,1,1,1,1,0,144,16,128
8599,167,37,20,6,3,1,2226,234,1992
8646,200,19,16,7,2,2,2088,246,1842
8650,7,1,0,0,1,0,84,9,75
8653,303,36,30,5,0,2,2802,376,2426
8656,8,1,0,0,0,0,72,9,63
8657,15,1,1,0,0,0,114,17,97
8658,107,11,5,0,1,0,984,124,860
8662,214,52,20,15,16,1,2340,318,2022
8669,4,1,1,0,0,0,66,6,60
8671,4,0,0,0,0,0,36,4,32
8672,5,1,2,1,0,0,66,9,57
8674,2,0,1,0,0,0,30,3,27
9074,225,16,14,6,0,3,2160,264,1896
0,0,0,0,0,0,0,0,0,0
0,0,0,0,0,0,0,0,0,0
0,0,0,0,0,0,0,0,0,0
0,0,0,0,0,0,0,0,0,0
0,0,0,0,0,0,0,0,0,0
0,0,0,0,0,0,0,0,0,0
8691,182,20,14,3,1,3,1734,223,1511
8694,4,1,0,0,0,0,36,5,31
8695,8,1,1,0,0,0,66,10,56
8703,402,50,22,33,2,6,4044,515,3529
8705,8,2,1,0,0,0,66,11,55
8706,11,2,0,0,0,0,96,13,83
8707,144,27,12,8,1,2,1620,194,1426
8710,13,2,0,0,0,0,138,15,123
8715,72,10,3,0,0,0,660,85,575
8720,13,1,2,0,0,1,138,17,121
8721,150,13,16,7,0,0,1542,186,1356
8724,7,1,0,0,0,0,90,8,82
0,0,0,0,0,0,0,0,0,0
0,0,0,0,0,0,0,0,0,0
0,0,0,0,0,0,0,0,0,0
0,0,0,0,0,0,0,0,0,0
0,0,0,0,0,0,0,0,0,0
0,0,0,0,0,0,0,0,0,0
8786,215,26,36,14,0,2,2406,293,2113
8790,34,4,3,0,0,1,438,42,396
8792,8,1,1,0,0,0,60,10,50
8794,14,1,0,0,0,1,120,16,104
8795,2,0,0,0,0,0,18,2,16
8797,52,8,4,3,0,0,660,67,593
8801,4,1,1,0,0,0,36,6,30
8803,15,2,0,0,0,0,126,17,109
8804,12,1,3,0,1,0,114,17,97
8805,12,1,3,0,1,0,114,17,97
8808,136,23,13,5,2,0,1266,179,1087
0,0,0,0,0,0,0,0,0,0
0,0,0,0,0,0,0,0,0,0
0,0,0,0,0,0,0,0,0,0
0,0,0,0,0,0,0,0,0,0
0,0,0,0,0,0,0,0,0,0
0,0,0,0,0,0,0,0,0,0
8828,11,1,0,0,0,1,90,13,77
8829,21,3,2,1,0,0,180,27,153
8832,163,17,6,1,0,1,1650,188,1462
8835,10,3,1,0,0,0,90,14,76
8838,160,20,13,2,0,0,1452,195,1257
8840,1836,170,117,82,21,27,17952,2253,15699
8843,153,29,33,6,1,5,1746,227,1519
8848,1441,183,103,66,10,14,14430,1817,12613
8850,201,22,14,10,0,2,1830,249,1581
8852,1643,197,133,49,6,33,15780,2061,13719
8857,1414,234,139,89,14,24,14610,1914,12696
8863,1307,216,119,71,17,20,14148,1750,12398
8880,5,0,2,0,0,0,60,7,53
8882,13,3,1,0,0,0,138,17,121
8883,20,0,1,1,0,0,150,22,128
8887,7,0,0,0,0,0,72,7,65
8891,1321,196,141,95,25,21,15210,1799,13411
8893,112,9,7,5,4,2,1116,139,977
8897,2,1,0,0,0,0,24,3,21
8901,1511,213,197,83,11,14,15222,2029,13193
8905,1065,143,100,19,5,13,9630,1345,8285
8907,225,29,20,2,2,1,2292,279,2013
8909,499,63,41,15,11,2,5070,631,4439
8912,12,1,1,0,0,0,114,14,100
8913,10,1,0,0,0,1,108,12,96
8914,12,4,1,1,0,0,138,18,120
8922,1073,102,73,20,11,9,10326,1288,9038
8926,1487,137,121,80,9,7,15240,1841,13399
8928,1048,88,79,61,6,7,10500,1289,9211
8930,1614,237,200,83,16,40,17952,2190,15762
8932,1452,165,95,54,14,13,14022,1793,12229
8942,13,2,3,1,0,0,96,19,77
8945,10,0,2,0,0,0,102,12,90
8948,11,0,1,0,0,0,102,12,90
8949,809,90,59,32,14,9,7434,1013,6421
8951,6,1,1,0,0,0,66,8,58
8952,6,2,0,0,0,1,84,9,75
8955,138,15,10,4,3,1,1410,171,1239
9057,123,19,13,3,3,0,1164,161,1003
9059,1687,240,186,61,26,22,16758,2222,14536
9061,16,1,1,0,3,0,138,21,117
9062,12,0,0,0,0,0,84,12,72
9065,22,1,1,1,0,0,198,25,173
9067,108,14,7,3,3,5,1356,140,1216
9069,1360,132,97,65,15,15,13752,1684,12068
9072,4,0,1,0,0,0,42,5,37
9078,3011,346,258,98,44,41,29076,3798,25278
9080,213,19,20,10,5,3,2292,270,2022
9085,5,0,0,0,1,0,60,6,54
9086,5,0,0,0,1,0,60,6,54
9087,1324,156,105,75,9,11,12624,1680,10944
9089,168,19,22,9,4,4,1722,226,1496
9093,1998,180,138,67,18,33,19326,2434,16892
9095,137,4,3,2,1,0,1428,147,1281
9099,1469,150,109,54,16,7,13758,1805,11953
9101,1732,171,142,81,8,11,17700,2145,15555
9103,187,28,19,12,0,1,2064,247,1817
9105,1089,158,126,45,26,36,11166,1480,9686
9107,1662,209,161,84,18,20,17028,2154,14874
9109,1742,208,172,65,52,15,16152,2254,13898
9111,2039,180,192,66,24,52,19800,2553,17247
9113,1,0,0,0,0,0,12,1,11
9116,298,39,26,20,6,2,2952,391,2561
9120,141,19,15,5,0,6,1524,186,1338
9122,304,46,29,4,2,0,2736,385,2351
9124,19,5,4,1,0,0,186,29,157
9126,19,4,1,0,0,0,168,24,144
9128,15,4,3,0,0,0,126,22,104
9130,18,3,1,1,0,0,138,23,115
9407,300,30,24,13,2,4,2748,373,2375
9409,15,1,2,1,0,0,120,19,101
9411,14,2,2,0,0,0,126,18,108
9414,12,1,0,0,0,0,90,13,77
9422,58,15,9,3,3,0,792,88,704
9429,141,26,6,4,1,0,1656,178,1478
9431,1277,152,110,59,17,28,13266,1643,11623
9434,44,6,5,1,0,1,462,57,405
9436,1866,237,188,57,24,24,17448,2396,15052
0,0,0,0,0,0,0,0,0,0
0,0,0,0,0,0,0,0,0,0
0,0,0,0,0,0,0,0,0,0
9450,1669,206,195,44,37,18,16332,2169,14163
9452,317,53,27,3,8,2,3198,410,2788
9457,1678,286,198,86,32,45,17820,2325,15495
9461,1455,182,158,73,35,33,15606,1936,13670
9465,8,4,3,0,1,0,108,16,92
9467,7,1,1,0,0,0,54,9,45
9469,166,28,20,11,0,3,1818,228,1590
9471,1933,244,200,87,16,45,18666,2525,16141
9473,2115,296,210,164,34,78,23772,2897,20875
9477,2031,181,193,66,24,52,19788,2547,17241
9479,262,25,19,3,0,1,2418,310,2108
9481,3,0,0,0,0,0,24,3,21
9482,9,3,1,0,1,0,138,14,124
9505,1658,234,150,54,28,28,17028,2152,14876
9507,62,8,4,0,0,0,570,74,496
9509,16,2,2,0,0,0,126,20,106
9510,1528,186,132,73,24,24,15846,1967,13879
9516,11,1,1,0,0,0,90,13,77
9517,12,2,1,1,0,0,108,16,92
9518,252,35,36,12,5,6,2610,346,2264
9520,4,1,1,0,0,0,48,6,42
9526,1716,269,196,51,20,26,17088,2278,14810
9528,242,31,21,11,6,5,3012,316,2696
9530,10,0,1,2,1,0,108,14,94
9532,1907,252,199,41,21,4,18288,2424,15864
9534,58,12,4,2,0,0,612,76,536
9538,2550,270,207,62,23,20,22866,3132,19734
9542,7,1,2,0,0,0,72,10,62
0,0,0,0,0,0,0,0,0,0
0,0,0,0,0,0,0,0,0,0
0,0,0,0,0,0,0,0,0,0
0,0,0,0,0,0,0,0,0,0
0,0,0,0,0,0,0,0,0,0
0,0,0,0,0,0,0,0,0,0
0,0,0,0,0,0,0,0,0,0
9561,1836,264,236,64,13,19,17790,2432,15358
9563,1896,148,108,71,23,18,17340,2264,15076
9565,206,20,17,4,0,3,1758,250,1508
9568,8,2,2,0,1,0,84,13,71
9571,12,3,2,0,0,0,108,17,91
9576,1751,193,142,61,28,23,18846,2198,16648
9588,2378,294,209,84,22,23,23004,3010,19994
9590,1539,177,119,49,23,15,15240,1922,13318
9592,58,8,9,2,2,4,960,83,877
9594,1834,187,165,71,29,15,18984,2301,16683
9597,12,3,2,0,1,0,126,18,108
9599,18,1,1,0,1,0,168,21,147
9600,4,5,2,0,0,0,66,11,55
9601,8,0,0,0,0,0,78,8,70
9604,2331,298,222,83,22,14,22572,2970,19602
9606,2523,213,165,56,21,27,22278,3005,19273
9608,2025,311,182,76,19,12,19032,2625,16407
9611,86,7,5,3,0,0,936,101,835
9613,2079,305,229,78,22,111,20766,2824,17942
9615,2533,217,182,81,20,16,22926,3049,19877
9618,1920,222,210,66,10,31,18738,2459,16279
9620,293,39,22,7,1,1,3030,363,2667
9623,286,46,26,12,4,7,3210,381,2829
9628,168,34,19,13,2,1,2022,237,1785
9633,14,6,2,1,0,0,138,23,115
9637,312,46,23,2,5,6,3108,394,2714
9639,14,1,1,1,0,0,108,17,91
9641,6,1,0,0,0,0,54,7,47
9642,12,0,0,0,0,0,78,12,66
9644,7,3,2,0,1,0,102,13,89
9646,6,0,0,1,0,0,78,7,71
9647,2218,244,218,63,16,64,22428,2823,19605
9650,2131,251,216,117,10,22,20880,2747,18133
9652,479,43,37,11,6,0,4104,576,3528
9654,2454,263,163,128,17,8,23052,3033,20019
9657,16,4,6,1,1,0,174,28,146
9658,1278,189,152,49,16,23,13722,1707,12015
9660,1486,250,192,77,20,19,15528,2044,13484
9662,1360,177,132,85,9,36,14442,1799,12643
0,0,0,0,0,0,0,0,0,0
9713,85,7,4,1,1,0,894,98,796
9715,2008,287,191,91,38,51,20976,2666,18310
9719,1837,225,146,119,27,31,18330,2385,15945
9721,1528,225,159,113,18,23,16104,2066,14038
9725,577,71,56,15,2,13,5538,734,4804
9726,229,61,30,7,2,3,2472,332,2140
9729,5,0,0,0,0,0,42,5,37
9730,13,5,1,0,0,0,156,19,137
9731,8,0,1,0,0,0,66,9,57
9733,10,2,3,1,0,0,96,16,80
9734,279,32,24,6,4,0,2982,345,2637
9738,13,0,0,0,0,0,84,13,71
9743,13,1,0,0,1,0,114,15,99
9744,13,1,0,0,1,0,114,15,99
9752,124,11,11,8,3,1,1176,158,1018
9757,9,1,0,0,1,0,120,11,109
9758,146,21,13,5,1,4,1506,190,1316
9761,1587,186,137,55,20,25,16392,2010,14382
9763,2246,233,195,72,14,24,20958,2784,18174
9765,930,81,74,35,8,7,9234,1135,8099
9767,194,26,19,6,3,1,1896,249,1647
9773,1886,230,183,67,12,8,17718,2386,15332
9775,1518,180,128,18,20,8,14118,1872,12246
9848,228,34,27,5,2,3,2568,299,2269
9852,215,32,14,13,3,3,2466,280,2186
9855,10,1,0,1,0,0,96,12,84
9856,13,1,1,1,0,0,120,16,104
9859,5,0,0,0,0,0,54,5,49
9866,461,53,49,2,6,1,4266,572,3694
9868,1574,159,103,71,14,25,15264,1946,13318
9870,1933,199,168,72,9,34,18348,2415,15933
9872,1636,196,142,61,10,20,15660,2065,13595
9874,1199,157,151,56,25,26,12486,1614,10872
9876,2204,242,220,82,22,38,20838,2808,18030
9878,2068,225,174,41,19,17,19602,2544,17058
9880,1635,162,119,60,4,16,14898,1996,12902
9882,1861,244,144,62,25,34,19140,2370,16770
9884,2202,247,173,24,20,13,19422,2679,16743
9886,2087,207,157,82,24,33,19518,2590,16928
9888,1446,127,107,43,2,31,13638,1756,11882
9890,1954,224,161,87,14,29,18948,2469,16479
9892,297,42,23,19,7,7,3900,395,3505
9894,7,0,0,0,0,0,54,7,47
9895,8,1,0,0,0,0,66,9,57
9899,144,17,11,8,0,3,1416,183,1233
9904,10,1,2,0,0,0,120,13,107
9908,439,64,51,16,11,9,5532,590,4942
9911,13,1,2,0,1,0,144,17,127
9912,7,2,2,0,0,0,66,11,55
9913,11,0,0,0,0,0,108,11,97
9920,9,1,0,0,0,0,78,10,68
9921,144,22,16,3,0,1,1320,186,1134
9929,12,2,0,1,0,0,126,15,111
9946,140,24,23,4,2,0,1332,193,1139
9950,507,60,35,13,11,2,5634,628,5006
9953,11,1,2,0,0,0,102,14,88
9955,19,1,0,1,0,0,138,21,117
9956,19,1,0,1,0,0,138,21,117
9958,12,3,1,0,0,0,96,16,80
9959,12,0,2,1,0,0,96,15,81
9960,8,3,3,0,2,0,108,16,92
9961,5,0,0,0,0,0,36,5,31
9965,1897,230,140,58,23,27,18396,2375,16021
9967,1862,246,169,92,21,23,19410,2413,16997
9969,1646,257,167,55,29,41,16692,2195,14497
9971,1404,129,85,84,11,8,13620,1721,11899
9974,1,0,0,0,0,0,18,1,17
9975,209,23,13,6,0,3,1956,254,1702
9978,1705,144,127,58,25,1,16578,2060,14518
9980,383,58,33,16,2,4,3690,496,3194
9982,609,84,55,30,4,1,5676,783,4893
9984,2147,219,155,49,22,11,19440,2603,16837
9988,1745,184,172,58,13,26,17040,2198,14842
9990,2134,282,232,73,12,17,20718,2750,17968
9992,1523,195,139,49,15,19,15276,1940,13336
9994,247,24,15,4,3,1,2472,294,2178
10001,8,0,0,0,0,0,90,8,82
10003,128,21,16,12,3,0,1392,180,1212
10007,126,25,21,6,3,0,1506,181,1325
10009,333,45,34,11,3,4,3294,430,2864
10011,3,0,0,0,0,0,36,3,33
10015,272,14,10,3,1,0,2304,300,2004
10027,143,18,8,1,0,0,1398,170,1228
10030,1350,165,129,75,25,18,14610,1762,12848
10032,1839,253,175,71,30,16,17910,2384,15526
10034,2319,298,193,116,12,48,23004,2986,20018
10036,342,52,37,13,3,1,3150,448,2702
10039,13,2,1,0,0,0,132,16,116
10050,1361,206,140,57,21,12,13548,1797,11751
10052,2279,266,179,60,15,16,20904,2815,18089
10055,87,8,10,10,2,1,1068,118,950
10058,6,0,0,1,0,0,66,7,59
10061,2587,353,243,118,24,36,25674,3361,22313
10063,3011,342,302,95,37,58,27786,3845,23941
10065,1347,193,164,91,15,29,13842,1839,12003
10067,1710,211,148,80,9,14,17136,2172,14964
10069,1428,191,124,69,11,17,13206,1840,11366
10071,1870,222,147,82,21,25,19434,2367,17067
10128,259,30,22,9,2,3,2400,325,2075
10148,204,25,21,7,1,1,1926,259,1667
10155,387,57,27,10,8,1,3744,490,3254
10157,11,2,2,0,0,0,120,15,105
10160,10,1,1,0,0,0,66,12,54
10168,672,91,62,8,9,2,5736,844,4892
10171,6,1,1,0,0,0,42,8,34
10173,190,12,10,6,1,1,1788,220,1568
10180,54,6,14,0,1,0,576,75,501
10182,365,24,14,5,5,1,4086,414,3672
10186,5,2,1,0,0,0,60,8,52
10191,2,0,0,1,0,0,24,3,21
10193,6,1,0,0,0,0,60,7,53
10194,4,2,0,0,0,1,60,7,53
10197,4,1,1,0,1,0,48,7,41
10198,191,18,12,5,3,0,1692,229,1463
10200,324,54,36,2,3,2,3036,421,2615
10204,120,4,4,7,3,2,1062,140,922
10206,1897,180,163,60,17,22,18510,2339,16171
10208,4,1,1,0,0,0,36,6,30
10209,6,0,0,0,0,0,42,6,36
10211,17,4,0,0,0,0,138,21,117
10212,7,1,1,0,0,0,72,9,63
10213,236,36,13,4,1,0,2514,290,2224
10215,1916,223,161,68,14,28,18120,2410,15710
10217,1947,257,211,77,34,26,19662,2552,17110
10219,1806,157,128,72,23,24,18552,2210,16342
10221,2475,301,231,78,31,41,24558,3157,21401
10223,143,22,11,3,1,2,1428,182,1246
10225,64,8,0,1,1,1,738,75,663
10227,280,38,32,8,4,2,3234,364,2870
10232,6,0,0,0,0,0,60,6,54
10234,13,0,1,0,0,0,96,14,82
10238,14,3,2,0,0,0,150,19,131
10241,56,1,2,0,0,0,504,59,445
10243,220,45,21,15,1,0,2388,302,2086
10245,226,22,9,11,4,1,2538,273,2265
10267,6,1,2,0,0,0,84,9,75
10276,7,0,0,0,0,0,90,7,83
10283,593,75,53,19,5,7,5436,752,4684
10291,43,4,3,1,0,0,384,51,333
10293,1439,181,166,43,29,11,14580,1869,12711
10295,2688,283,250,90,22,36,26334,3369,22965
10297,1907,211,232,61,28,24,18594,2463,16131
10300,174,12,7,4,1,0,1464,198,1266
10304,1900,200,151,52,9,10,17568,2322,15246
10307,1923,188,199,44,12,6,18072,2372,15700
10311,1510,187,151,84,14,18,15048,1964,13084
10316,1485,158,91,60,12,21,15702,1827,13875
10318,2551,323,203,109,25,42,26388,3253,23135
10320,1538,218,166,92,45,36,15288,2095,13193
10325,11,0,0,0,0,0,114,11,103
10332,13,3,2,0,0,0,108,18,90
10333,124,15,6,1,1,0,1182,147,1035
10335,243,60,29,8,1,2,2478,343,2135
0,0,0,0,0,0,0,0,0,0
10353,261,38,21,11,0,1,2478,332,2146
10355,5,2,1,0,0,0,48,8,40
10356,233,43,36,10,2,6,2490,330,2160
10360,10,2,1,0,0,0,102,13,89
0,0,0,0,0,0,0,0,0,0
10366,159,13,12,5,1,0,1650,190,1460
10376,307,35,33,5,4,1,2946,385,2561
10380,16,3,1,1,0,0,150,21,129
10384,77,1,2,9,0,0,894,89,805
10386,1375,196,179,82,5,54,14922,1891,13031
10388,1637,207,141,55,17,42,15636,2099,13537
10390,1842,224,180,60,15,20,16722,2341,14381
10395,165,8,3,3,4,0,1638,183,1455
10412,1642,208,157,76,18,22,16260,2123,14137
10414,1455,171,146,37,20,58,15120,1887,13233
10416,1869,241,159,83,23,24,18834,2399,16435
10418,1632,153,155,41,13,8,16998,2002,14996
10425,10,0,1,0,0,0,90,11,79
10427,10,1,0,0,0,0,96,11,85
10432,403,51,26,8,1,0,4182,489,3693
10434,84,6,9,1,0,0,804,100,704
10436,130,17,8,8,0,0,1290,163,1127
10438,97,8,4,1,1,0,990,111,879
10443,11,1,1,1,0,0,96,14,82
10445,4,1,1,0,0,0,42,6,36
10449,120,17,8,3,1,0,1488,149,1339
10451,289,39,35,4,6,3,2868,376,2492
10453,58,3,2,0,1,0,672,64,608
10468,241,26,21,6,0,2,2322,296,2026
11314,176,37,19,7,4,5,1956,248,1708
10483,163,36,28,6,0,2,1806,235,1571
10486,18,1,1,0,0,0,138,20,118
10487,20,5,2,0,0,0,162,27,135
10488,386,26,17,4,0,0,3810,433,3377
10495,1735,194,121,65,22,9,15870,2146,13724
10497,1576,226,174,68,21,32,16122,2097,14025
10499,1732,222,148,65,21,29,16554,2217,14337
10501,1856,213,150,89,16,17,17460,2341,15119
10503,2038,178,157,74,9,12,19020,2468,16552
10505,1348,144,113,72,10,32,14262,1719,12543
10507,1906,218,162,59,24,27,19098,2396,16702
10509,2063,275,215,59,9,50,20124,2671,17453
10511,310,25,19,4,0,1,2772,359,2413
10516,8,0,0,0,0,0,54,8,46
10530,86,12,6,2,0,0,900,106,794
10531,98,16,8,3,3,2,1122,130,992
10538,22,1,2,3,0,0,276,28,248
10549,12,2,1,1,1,1,114,18,96
10550,175,32,17,2,2,3,1782,231,1551
10554,166,19,16,6,3,1,1926,211,1715
10556,4,1,0,0,0,0,36,5,31
10558,6,0,1,0,0,0,72,7,65
10560,118,7,6,4,0,1,1164,136,1028
10575,316,50,42,9,6,4,3696,427,3269
10577,8,2,1,0,0,0,60,11,49
10579,8,1,0,0,0,0,66,9,57
10580,10,1,0,0,0,0,108,11,97
10581,137,31,18,3,2,1,1596,192,1404
10583,1154,156,106,62,17,25,12186,1520,10666
10585,2031,263,172,88,11,22,19242,2587,16655
10590,2078,184,135,83,7,8,18888,2495,16393
10593,2323,220,181,48,14,8,22104,2794,19310
10595,1664,166,136,53,27,12,16170,2058,14112
10597,1929,278,157,63,19,41,18996,2487,16509
10599,1666,206,190,84,24,41,15732,2211,13521
10601,2119,295,209,164,34,78,23736,2899,20837
10603,177,13,24,7,3,0,1608,224,1384
10606,190,20,6,10,1,0,1716,227,1489
10616,69,6,7,5,0,0,756,87,669
10618,1,0,0,0,0,0,30,1,29
10620,167,21,16,3,2,1,1590,210,1380
10623,9,0,2,0,0,0,84,11,73
10624,10,1,2,0,0,0,96,13,83
10626,275,50,35,10,4,4,2532,378,2154
10630,9,0,0,0,0,0,72,9,63
10699,1544,139,132,51,8,30,15102,1904,13198
10634,5,1,0,0,0,0,60,6,54
10697,240,27,13,11,20,1,2976,312,2664
10701,1787,205,156,64,16,17,17640,2245,15395
10703,1200,134,105,44,8,20,11490,1511,9979
10705,2180,237,175,54,21,17,21804,2684,19120
10707,2160,249,214,55,39,28,21384,2745,18639
10709,1373,134,129,43,8,13,13332,1700,11632
10711,1694,197,153,64,27,15,16920,2150,14770
10714,1026,141,127,83,14,28,10938,1419,9519
10716,1120,162,102,52,5,30,12138,1471,10667
10718,1727,239,166,52,14,12,16056,2210,13846
10720,1500,148,117,73,13,33,14202,1884,12318
10722,1668,239,180,95,20,25,16182,2227,13955
10724,1506,171,122,81,28,26,15402,1934,13468
10726,80,6,4,0,0,0,804,90,714
10815,367,45,27,20,6,1,4140,466,3674
10844,91,7,4,3,0,0,900,105,795
10864,386,59,33,15,2,2,3582,497,3085
10866,5,0,0,0,0,0,54,5,49
0,0,0,0,0,0,0,0,0,0
0,0,0,0,0,0,0,0,0,0
10875,140,8,3,3,1,0,1518,155,1363
10881,185,26,18,10,4,6,2028,249,1779
10895,201,30,14,6,0,2,2022,253,1769
10899,3,0,0,0,0,0,24,3,21
10900,4,0,0,0,0,0,30,4,26
10911,89,5,5,3,0,0,1134,102,1032
10913,12,0,1,0,0,0,96,13,83
10914,4,0,0,0,0,0,48,4,44
10916,3,0,0,0,0,0,42,3,39
10952,1987,287,182,101,18,23,19728,2598,17130
10954,1815,259,149,41,32,11,18306,2307,15999
10956,1912,288,198,122,22,16,18762,2558,16204
10958,1285,163,129,48,25,9,12594,1659,10935
10960,1377,172,141,69,20,9,13980,1788,12192
10962,211,16,9,8,2,1,1884,247,1637
10964,1154,221,136,86,30,28,13710,1655,12055
10966,1459,216,152,63,13,23,15744,1926,13818
10974,162,22,21,4,2,0,1674,211,1463
10976,7,2,0,1,0,0,102,10,92
10977,8,1,0,0,0,0,90,9,81
10986,209,32,15,5,0,0,2028,261,1767
10989,6,0,0,0,0,0,54,6,48
0,0,0,0,0,0,0,0,0,0
11012,176,16,10,2,0,0,1740,204,1536
11023,5,0,0,0,0,0,48,5,43
11024,8,2,0,0,0,0,78,10,68
11029,89,19,7,0,0,4,930,119,811
11031,26,2,1,0,0,0,186,29,157
11034,499,39,28,18,4,1,4674,589,4085
11036,3,0,0,0,0,0,36,3,33
11037,11,1,0,0,0,0,78,12,66
11038,11,0,0,1,0,0,108,12,96
11041,129,7,5,3,0,0,1002,144,858
11043,295,36,15,24,18,3,3030,391,2639
11050,151,18,15,5,2,2,1470,193,1277
11052,17,2,1,0,0,0,138,20,118
11053,9,0,0,0,0,0,66,9,57
11063,313,33,25,5,2,1,2568,379,2189
11066,16,0,1,0,0,0,132,17,115
11072,23,1,0,0,0,0,168,24,144
11074,14,2,2,0,0,0,114,18,96
11075,91,10,12,2,0,0,846,115,731
11077,2020,175,143,90,35,21,19974,2484,17490
11079,1674,199,147,60,20,9,17796,2109,15687
11081,1815,184,155,100,28,33,17100,2315,14785
11084,1417,137,101,80,30,12,13764,1777,11987
11086,1651,190,163,59,26,13,16908,2102,14806
11088,1725,194,174,56,13,58,16860,2220,14640
11090,1717,225,140,65,12,13,16218,2172,14046
11092,308,50,31,6,9,2,2790,406,2384
11094,2531,265,288,118,24,31,24606,3257,21349
11096,2286,236,156,75,8,17,20748,2778,17970
11098,1752,217,179,89,31,43,18138,2311,15827
11100,2050,233,197,54,10,20,19482,2564,16918
14681,8,1,0,0,0,0,72,9,63
11106,206,25,13,5,1,0,2166,250,1916
11113,162,24,15,7,0,0,1506,208,1298
11128,137,20,4,0,1,0,1134,162,972
11133,18,1,1,0,0,0,120,20,100
11134,9,0,0,2,0,0,84,11,73
11169,64,10,7,0,0,0,774,81,693
11172,4,0,0,0,0,0,42,4,38
11174,344,43,19,2,3,0,2976,411,2565
11177,291,34,22,7,4,6,3336,364,2972
11179,150,19,15,0,0,0,1458,184,1274
11182,6,0,0,0,0,0,42,6,36
11184,750,83,55,17,5,5,7740,915,6825
11186,2205,277,203,95,20,21,21294,2821,18473
11188,3018,325,224,76,30,23,28584,3696,24888
11190,0,0,0,0,0,0,0,0,0
11193,19,3,0,0,1,0,156,23,133
11194,10,3,3,1,0,0,132,17,115
11195,15,3,1,0,0,0,132,19,113
11197,10,0,0,0,0,0,66,10,56
11212,28,6,4,0,0,0,384,38,346
11214,175,31,24,7,1,2,2106,240,1866
11217,262,38,28,13,3,7,3078,351,2727
12882,44,3,0,0,0,0,498,47,451
11397,78,20,13,1,1,0,786,113,673
11223,429,55,34,6,2,2,3972,528,3444
11225,99,9,16,3,0,1,834,128,706
11227,159,18,10,3,1,0,1554,191,1363
11262,53,10,4,8,0,0,474,75,399
11242,210,27,25,11,3,2,1968,278,1690
11251,228,20,17,6,2,1,2322,274,2048
11253,269,40,29,9,7,7,2718,361,2357
11264,4,0,0,0,0,0,24,4,20
11267,1068,160,104,46,15,31,11310,1424,9886
11269,1034,167,108,61,6,35,10590,1411,9179
11271,1740,265,181,77,13,32,18828,2308,16520
11273,2400,339,258,100,21,42,23694,3160,20534
11275,1320,139,106,57,33,15,13644,1670,11974
11293,178,22,13,5,3,1,1746,222,1524
11295,13,1,1,0,0,0,108,15,93
11296,13,1,2,1,0,0,120,17,103
11298,10,0,0,0,0,0,78,10,68
11320,2372,205,136,55,12,20,21432,2800,18632
11322,2011,167,123,65,20,29,19128,2415,16713
11324,1956,268,217,118,14,15,19530,2588,16942
11326,1708,232,224,64,24,38,17226,2290,14936
11329,66,11,7,0,1,2,690,87,603
11333,255,33,29,8,1,4,2658,330,2328
11335,7,1,1,0,0,0,72,9,63
11336,4,0,0,0,0,0,36,4,32
11339,5,1,1,1,0,0,54,8,46
11340,7,1,1,0,0,0,48,9,39
11341,4,1,0,0,0,0,42,5,37
11350,77,23,10,7,0,0,1008,117,891
11353,249,31,19,3,0,0,2526,302,2224
11355,5,2,1,0,0,0,60,8,52
0,0,0,0,0,0,0,0,0,0
11370,169,33,19,12,1,3,2064,237,1827
11373,262,23,16,6,0,3,2628,310,2318
11375,4,1,0,0,0,0,42,5,37
11391,86,15,4,0,0,0,822,105,717
11411,13,2,3,0,0,0,114,18,96
11412,13,2,3,0,0,0,114,18,96
11418,454,80,53,7,4,2,4218,600,3618
11427,28,4,3,0,0,1,300,36,264
11432,291,32,22,3,2,6,2712,356,2356
11434,8,0,0,0,0,0,54,8,46
11435,18,5,1,0,0,3,144,27,117
11436,18,5,1,0,0,3,144,27,117
11438,10,0,0,0,0,0,72,10,62
11443,1444,167,126,56,34,19,14334,1846,12488
11445,397,33,27,8,3,1,4314,469,3845
11447,1583,177,123,40,10,12,15510,1945,13565
11449,1475,182,138,42,18,18,13902,1873,12029
11459,1172,124,90,26,20,14,11712,1446,10266
11461,1991,214,171,89,19,20,20838,2504,18334
11463,1716,228,174,112,26,80,17802,2336,15466
11465,172,29,14,8,0,2,2034,225,1809
11467,1608,187,129,52,13,21,15648,2010,13638
11469,2178,254,171,88,20,17,20646,2728,17918
11471,1214,159,116,56,28,20,12852,1593,11259
11473,1983,226,164,70,22,28,19392,2493,16899
11475,2506,244,191,58,32,3,22818,3034,19784
11482,101,12,11,2,0,1,1014,127,887
11485,9,2,2,0,0,0,72,13,59
11510,34,2,1,5,2,1,426,45,381
11516,5,0,0,0,0,0,30,5,25
11517,6,0,0,0,0,0,48,6,42
11518,3,1,1,0,0,0,30,5,25
11519,6,0,0,0,0,0,48,6,42
11522,256,21,18,4,1,1,2610,301,2309
11524,15,0,1,0,0,0,144,16,128
11525,15,0,1,0,0,0,144,16,128
11526,18,1,2,0,0,0,144,21,123
11541,400,63,30,33,5,3,3990,534,3456
11565,189,20,14,5,0,3,1836,231,1605
11572,10,1,1,0,0,0,66,12,54
11573,4,0,0,0,0,0,30,4,26
11578,55,2,3,0,0,0,762,60,702
11582,5,0,0,0,0,0,42,5,37
11587,1753,253,176,68,29,20,17136,2299,14837
11589,1604,156,111,43,15,2,14832,1931,12901
11591,1259,140,84,41,17,18,13578,1559,12019
11593,1766,278,169,93,35,34,17580,2375,15205
11596,1499,129,141,58,21,41,15504,1889,13615
11598,1879,223,148,30,18,23,17166,2321,14845
11600,1910,218,167,67,20,8,18636,2390,16246
11602,3239,312,231,69,21,12,31242,3884,27358
11604,262,22,11,2,3,4,2586,304,2282
11607,7,2,2,0,0,0,60,11,49
11608,79,15,9,1,1,0,834,105,729
11625,348,48,13,21,2,0,3660,432,3228
11636,7,1,1,0,0,0,66,9,57
11648,502,26,23,6,0,8,5262,565,4697
11653,3,1,0,0,0,0,36,4,32
11655,263,27,22,7,4,3,2478,326,2152
11658,185,46,30,10,7,14,2250,292,1958
11663,8,0,0,0,0,0,66,8,58
11665,385,60,37,13,1,6,3864,502,3362
11679,13,1,1,0,0,0,126,15,111
11680,4,1,0,0,0,0,48,5,43
11681,5,1,0,0,0,0,78,6,72
11688,10,3,2,0,0,0,120,15,105
11689,14,1,0,0,0,0,120,15,105
11694,152,20,24,4,4,1,1686,205,1481
11702,1376,194,192,61,14,36,14040,1873,12167
11704,1753,226,127,49,20,44,17538,2219,15319
11706,1846,180,128,58,8,23,18264,2243,16021
11708,2302,248,168,108,18,23,22920,2867,20053
11710,1242,155,103,68,13,37,12792,1618,11174
11712,1372,188,135,61,27,12,13578,1795,11783
11714,1823,197,142,102,11,45,18606,2320,16286
11716,1808,255,173,105,22,75,19272,2438,16834
13693,263,47,18,12,7,1,2406,348,2058
11721,236,19,19,11,0,2,2760,287,2473
11723,152,19,10,0,1,0,1698,182,1516
11730,320,61,21,8,0,0,3156,410,2746
11737,10,3,1,0,0,0,90,14,76
11738,10,3,1,0,0,0,90,14,76
11740,6,0,1,0,0,0,48,7,41
11741,7,0,0,0,0,0,48,7,41
11774,152,12,8,6,2,0,1266,180,1086
11777,11,1,2,1,0,0,102,15,87
11786,248,25,17,4,8,2,2418,304,2114
11788,332,56,35,14,4,4,3414,445,2969
11790,1392,149,142,37,13,12,14280,1745,12535
11792,324,21,14,6,1,3,3240,369,2871
11794,135,26,15,6,2,0,1422,184,1238
11798,10,1,1,0,0,0,78,12,66
11802,410,32,12,3,1,0,3564,458,3106
11804,1195,147,105,57,11,8,11490,1523,9967
11806,1411,226,171,89,25,36,14706,1958,12748
11809,1113,181,167,97,18,38,12228,1614,10614
11811,1482,199,151,32,17,7,14868,1888,12980
11813,1379,195,134,43,21,26,13320,1798,11522
11815,1058,172,135,39,11,10,11316,1425,9891
11817,1367,175,139,47,11,21,14622,1760,12862
11819,1631,205,227,114,20,71,17934,2268,15666
11832,7,3,1,1,0,1,90,13,77
11833,13,1,2,1,0,1,120,18,102
11836,13,1,1,0,0,0,120,15,105
11837,247,33,25,6,5,3,2754,319,2435
11843,160,19,22,6,1,2,1902,210,1692
11849,118,11,10,2,2,1,1164,144,1020
11865,251,19,19,7,2,0,2118,298,1820
11873,4,0,0,0,0,0,36,4,32
11874,253,26,20,2,6,2,2592,309,2283
11877,8,3,4,0,0,0,114,15,99
0,0,0,0,0,0,0,0,0,0
0,0,0,0,0,0,0,0,0,0
11888,288,32,27,2,4,3,2658,356,2302
0,0,0,0,0,0,0,0,0,0
11905,84,7,3,1,1,0,666,96,570
11907,1023,140,89,36,20,13,10596,1321,9275
11909,1387,147,137,50,43,24,14778,1788,12990
11913,1838,231,160,59,30,25,17568,2343,15225
11917,12,2,0,0,0,0,102,14,88
11918,12,2,0,0,0,0,102,14,88
0,0,0,0,0,0,0,0,0,0
0,0,0,0,0,0,0,0,0,0
0,0,0,0,0,0,0,0,0,0
0,0,0,0,0,0,0,0,0,0
0,0,0,0,0,0,0,0,0,0
11982,341,34,17,14,6,1,3510,413,3097
0,0,0,0,0,0,0,0,0,0
11987,1619,245,185,52,32,24,16584,2157,14427
11989,1029,114,94,35,12,30,10170,1314,8856
11992,1170,177,118,41,13,11,13206,1530,11676
11994,1341,166,121,55,15,13,13218,1711,11507
12022,268,26,21,5,5,5,3000,330,2670
0,0,0,0,0,0,0,0,0,0
0,0,0,0,0,0,0,0,0,0
12054,9,1,1,0,0,0,102,11,91
12059,5,2,1,1,0,0,54,9,45
12066,58,6,4,1,0,0,618,69,549
12074,135,23,8,9,1,1,1308,177,1131
12079,8,3,2,1,0,0,96,14,82
12081,16,4,4,0,0,1,144,25,119
12082,13,1,0,1,0,0,108,15,93
12125,194,38,25,15,0,6,2274,278,1996
12152,345,59,43,12,4,7,3300,470,2830
12156,8,1,0,0,1,0,66,10,56
12158,8,2,3,0,0,0,90,13,77
12208,99,16,14,3,4,3,912,139,773
12241,205,23,12,5,1,2,2106,248,1858
12243,1346,187,142,35,22,20,14064,1752,12312
12245,2790,288,197,78,26,26,25782,3405,22377
12247,2244,309,203,53,33,16,21558,2858,18700
12249,1095,178,102,52,11,5,11160,1443,9717
12251,2153,241,158,70,17,15,20808,2654,18154
12253,1867,177,146,67,37,20,18690,2314,16376
12255,1367,280,168,49,25,15,13416,1904,11512
12260,1699,161,128,35,24,6,15894,2053,13841
12262,2160,233,169,78,26,31,19980,2697,17283
12267,10,1,0,0,0,0,90,11,79
12270,162,17,14,1,0,1,1734,195,1539
12272,254,23,21,6,8,2,2646,314,2332
12276,17,1,2,0,0,0,120,20,100
12278,11,2,2,0,0,0,126,15,111
12282,9,0,0,0,0,0,72,9,63
12283,9,0,1,0,1,0,96,11,85
12284,7,0,0,0,0,0,60,7,53
12285,7,0,0,0,0,0,60,7,53
12286,209,23,15,3,1,0,2028,251,1777
12310,237,39,21,5,1,0,2370,303,2067
0,0,0,0,0,0,0,0,0,0
12324,233,23,12,2,0,0,2250,270,1980
12326,83,6,4,1,0,0,738,94,644
12354,20,4,2,0,0,0,186,26,160
12364,8,2,1,0,0,0,90,11,79
12378,202,22,10,8,7,8,1860,257,1603
12383,229,20,10,0,5,2,1944,266,1678
12385,73,4,1,1,0,0,882,79,803
12392,1450,132,97,46,11,13,13794,1749,12045
12394,1586,222,129,46,45,13,16272,2041,14231
12396,1004,102,92,47,19,9,9552,1273,8279
12398,0,0,0,0,0,0,0,0,0
12400,2045,207,170,47,14,7,19458,2490,16968
12402,2067,237,177,68,5,28,19800,2582,17218
12407,16,2,1,1,0,0,138,20,118
12408,7,1,0,0,0,0,66,8,58
12409,14,4,2,0,1,0,108,21,87
12432,208,28,14,7,3,0,2100,260,1840
12437,281,54,39,15,1,5,2844,395,2449
12441,9,0,1,0,0,0,78,10,68
12461,310,37,31,3,3,3,3282,387,2895
12468,25,3,1,1,0,0,180,30,150
12469,10,1,1,0,0,0,72,12,60
12472,12,0,0,2,0,0,102,14,88
12473,105,17,8,6,0,4,1014,140,874
12855,120,18,16,4,6,3,1212,167,1045
12491,109,11,14,5,1,0,1002,140,862
12501,4,0,0,1,0,0,48,5,43
12504,8,1,1,0,0,0,90,10,80
12505,11,0,1,0,0,0,102,12,90
12523,155,22,10,3,2,0,1740,192,1548
12525,1681,162,143,82,18,21,15288,2107,13181
12527,1115,140,95,37,11,21,10716,1419,9297
12529,1440,128,94,49,20,6,14070,1737,12333
12531,908,134,114,46,7,14,8868,1223,7645
12533,3147,319,239,145,35,36,29640,3921,25719
12535,1195,123,91,31,8,8,11730,1456,10274
12537,1613,172,129,38,19,12,14748,1983,12765
12539,1662,148,125,48,10,36,14712,2029,12683
12541,157,20,15,1,1,1,1440,195,1245
12545,10,1,2,0,0,0,90,13,77
12546,10,1,2,0,0,0,90,13,77
12552,5,0,0,0,0,0,42,5,37
12553,5,3,2,0,0,0,54,10,44
12556,13,1,1,0,0,0,108,15,93
0,0,0,0,0,0,0,0,0,0
12578,116,16,10,2,1,5,1038,150,888
12580,7,1,1,0,0,1,84,10,74
12598,67,7,8,0,1,0,870,83,787
12609,111,14,8,3,2,1,1374,139,1235
12627,135,12,8,5,0,1,1152,161,991
12631,9,0,0,1,0,0,72,10,62
12645,3663,368,266,132,47,25,33240,4501,28739
12647,434,78,37,27,8,5,4488,589,3899
12649,2109,237,176,99,26,28,20070,2675,17395
12653,1070,201,155,80,24,30,12954,1560,11394
12655,1667,207,159,66,20,32,17040,2151,14889
12657,1900,258,229,101,29,29,18888,2546,16342
12659,1412,172,125,54,9,20,13818,1792,12026
12661,1944,237,147,90,28,9,19080,2455,16625
12677,15,0,1,0,0,0,138,16,122
12679,383,52,38,12,5,13,4068,503,3565
12684,12,3,2,0,0,0,120,17,103
12686,6,3,1,0,0,0,60,10,50
12691,14,6,2,0,0,0,132,22,110
12692,145,18,18,1,1,1,1896,184,1712
12696,227,16,16,5,3,0,2208,267,1941
12713,175,10,9,7,0,0,1602,201,1401
12729,86,21,5,1,0,5,1074,118,956
12731,15,0,1,0,0,0,114,16,98
12732,10,0,1,1,0,0,102,12,90
12734,4,0,0,0,0,0,42,4,38
12735,62,11,8,6,0,2,684,89,595
12988,233,14,14,6,0,1,2238,268,1970
12742,84,4,1,0,0,0,792,89,703
12744,320,38,30,3,4,1,3312,396,2916
12746,240,41,21,7,2,2,2700,313,2387
12748,13,1,0,0,0,0,144,14,130
12749,12,3,2,0,0,0,120,17,103
12750,12,3,2,0,0,0,120,17,103
12755,16,2,2,0,0,0,156,20,136
12757,15,3,3,0,0,0,126,21,105
12761,17,2,2,0,0,0,150,21,129
12764,8,1,1,0,0,0,60,10,50
12766,72,16,7,9,0,3,912,107,805
12769,376,27,7,13,6,1,4212,430,3782
12771,1426,237,146,64,42,29,16482,1944,14538
12775,1127,142,93,38,13,14,11028,1427,9601
12778,1646,194,136,88,2,19,15612,2085,13527
12782,1157,205,145,74,22,24,11586,1627,9959
12784,1166,107,85,41,16,15,11694,1430,10264
12786,1605,175,136,69,24,17,15654,2026,13628
12788,2284,233,171,81,34,24,20910,2827,18083
12790,1849,155,124,51,20,23,18330,2222,16108
12792,1852,193,181,65,28,30,19710,2349,17361
12794,1535,197,208,99,25,38,16266,2102,14164
12796,1167,135,138,99,12,19,12498,1570,10928
12798,403,42,32,9,10,4,4098,500,3598
12800,311,46,26,17,3,1,3000,404,2596
12802,302,35,21,6,4,4,2790,372,2418
12804,10,0,0,0,0,0,102,10,92
12806,10,2,0,1,1,3,132,17,115
12807,5,1,0,1,0,0,54,7,47
12858,218,38,19,6,2,4,2184,287,1897
12869,45,3,3,0,0,0,450,51,399
12871,9,2,1,0,0,0,96,12,84
12874,17,3,3,0,0,0,156,23,133
12880,52,7,1,1,3,0,564,64,500
12884,1509,233,147,65,14,16,15228,1984,13244
12886,1307,148,113,32,24,16,12258,1640,10618
12888,1661,152,121,55,41,31,15954,2061,13893
12892,2048,207,158,55,17,36,19782,2521,17261
12894,1538,182,139,59,34,17,15318,1969,13349
12896,1402,173,134,90,19,42,14934,1860,13074
12898,1904,179,135,42,53,14,18822,2327,16495
12900,1908,251,165,61,62,16,19596,2463,17133
12902,854,150,110,51,14,44,9558,1223,8335
12904,4,0,0,0,0,0,36,4,32
12905,196,57,25,11,7,7,2202,303,1899
12916,260,25,19,6,0,0,2436,310,2126
12918,78,16,9,0,1,1,924,105,819
12929,10,1,0,0,0,0,90,11,79
12930,1,0,0,0,0,0,36,1,35
12931,5,0,1,0,0,0,54,6,48
12937,4,2,0,0,0,1,48,7,41
12939,6,1,1,0,0,0,60,8,52
12941,15,1,2,1,0,0,132,19,113
12942,5,0,0,0,1,0,48,6,42
12944,124,17,11,5,1,1,1146,159,987
0,0,0,0,0,0,0,0,0,0
12969,134,18,20,5,4,1,1440,182,1258
12973,1270,190,133,19,14,9,11886,1635,10251
12975,1921,268,125,58,14,9,18324,2395,15929
12977,914,107,74,36,21,13,9354,1165,8189
12979,1362,153,138,67,23,28,13890,1771,12119
12981,1458,186,132,72,13,12,14352,1873,12479
12992,9,0,0,0,0,0,60,9,51
12998,121,13,6,0,1,0,1284,141,1143
0,0,0,0,0,0,0,0,0,0
13007,3,1,0,0,0,0,24,4,20
13008,11,2,0,0,0,0,96,13,83
13009,8,0,0,0,0,0,54,8,46
13011,100,10,4,2,0,0,906,116,790
13018,275,28,26,8,13,5,3186,355,2831
13020,226,22,11,10,0,2,2076,271,1805
13022,15,0,1,0,0,0,132,16,116
13024,139,14,10,11,3,2,1614,179,1435
13031,203,26,17,7,1,2,1788,256,1532
13076,222,24,23,7,2,5,2256,283,1973
13080,14,1,1,1,0,0,120,17,103
13081,7,0,1,0,0,0,84,8,76
13084,2,1,0,0,0,0,42,3,39
0,0,0,0,0,0,0,0,0,0
13114,1917,201,124,49,11,17,18348,2319,16029
13117,2035,235,174,49,19,21,18444,2533,15911
13120,2089,292,249,115,17,33,20874,2795,18079
13122,1775,156,136,77,20,46,17550,2210,15340
13124,1257,203,133,52,41,26,13176,1712,11464
13126,1677,197,136,64,20,24,17634,2118,15516
13128,1638,193,140,66,18,29,16728,2084,14644
13130,2032,231,154,70,6,39,18822,2532,16290
13134,939,107,89,45,20,21,9252,1221,8031
13136,15,0,0,0,0,0,258,15,243
13141,15,0,1,0,0,0,120,16,104
13142,232,26,26,11,3,9,2718,307,2411
13144,10,1,1,0,0,1,102,13,89
13145,6,1,0,1,0,0,66,8,58
13147,6,0,1,0,0,0,84,7,77
13149,74,12,7,4,1,0,918,98,820
13153,88,4,6,0,0,0,876,98,778
13163,117,16,21,12,0,4,1368,170,1198
13166,4,1,0,0,0,1,90,6,84
13179,39,7,1,3,0,1,462,51,411
13189,1159,148,134,47,6,16,12174,1510,10664
13191,980,138,101,49,5,19,10380,1292,9088
13195,2364,215,184,63,14,13,21630,2853,18777
13198,1710,237,178,74,15,18,17196,2232,14964
13200,2033,286,197,75,14,29,20442,2634,17808
13202,4172,512,348,127,54,33,38568,5246,33322
13204,1544,186,182,73,14,12,15114,2011,13103
13213,239,37,27,7,5,3,2652,318,2334
13219,160,25,13,4,2,2,2088,206,1882
13221,4,0,1,0,0,0,54,5,49
13222,3,0,1,0,0,0,36,4,32
13223,8,2,0,0,0,0,84,10,74
13224,354,51,29,12,1,2,3504,449,3055
13226,19,2,2,0,0,0,168,23,145
13228,12,2,0,1,0,0,120,15,105
13229,207,21,13,3,0,1,2022,245,1777
13242,6,0,0,0,0,0,42,6,36
13246,114,15,5,0,0,0,1026,134,892
13248,107,5,3,2,0,0,1134,117,1017
13253,5,1,0,0,0,0,48,6,42
13254,5,0,0,0,0,0,48,5,43
13256,3,0,0,0,0,0,30,3,27
13257,2,0,0,1,0,0,48,3,45
13258,341,40,28,3,3,3,3144,418,2726
13261,13,0,0,0,0,1,108,14,94
13262,8,0,1,0,0,0,78,9,69
13263,14,3,1,0,0,0,126,18,108
13264,233,29,21,13,5,2,2586,303,2283
13270,146,11,1,0,2,0,1392,160,1232
13277,8,1,0,0,0,0,78,9,69
13286,1151,164,118,66,30,53,11406,1582,9824
13304,1199,169,98,43,17,17,12096,1543,10553
0,0,0,0,0,0,0,0,0,0
13337,266,20,12,3,0,0,2412,301,2111
13342,1715,211,169,80,15,26,16530,2216,14314
13344,1461,152,104,40,21,15,14568,1793,12775
13346,2155,199,149,61,14,12,19962,2590,17372
13348,1457,232,198,50,24,18,15594,1979,13615
13350,1645,203,162,68,14,18,16146,2110,14036
13352,61,10,5,1,1,0,798,78,720
13356,235,18,14,15,5,4,2604,291,2313
13358,9,1,0,0,0,0,90,10,80
13362,275,33,26,14,3,3,2886,354,2532
13366,11,1,0,0,0,1,84,13,71
13378,147,6,1,1,0,0,1206,155,1051
13385,238,39,25,17,6,8,2850,333,2517
13400,334,39,39,15,4,3,3552,434,3118
13411,169,11,4,4,2,1,1716,191,1525
13423,1276,211,155,31,25,14,12720,1712,11008
13425,1530,173,147,42,8,25,14898,1925,12973
13427,2238,269,204,86,26,23,20976,2846,18130
13429,1577,197,122,71,16,24,15708,2007,13701
13431,762,87,58,47,3,10,8286,967,7319
13433,1715,239,177,50,24,20,17112,2225,14887
13435,1603,199,143,53,29,21,16464,2048,14416
13437,1388,198,148,52,8,18,13926,1812,12114
13439,45,7,6,0,0,0,516,58,458
13443,120,23,10,5,1,2,1428,161,1267
13476,246,20,18,13,3,0,2484,300,2184
13486,219,42,19,7,4,2,2148,293,1855
13492,11,2,2,0,0,0,72,15,57
13495,6,0,0,0,0,0,48,6,42
13497,8,0,0,0,0,0,66,8,58
13510,309,29,20,6,3,2,3318,369,2949
13518,238,24,11,2,1,1,2394,277,2117
13520,3,1,0,0,0,0,60,4,56
13523,4,0,0,0,0,0,60,4,56
13524,6,1,0,1,0,0,66,8,58
13525,141,8,6,1,0,0,1356,156,1200
13528,145,17,8,0,2,1,1434,173,1261
13536,200,27,14,4,4,4,2040,253,1787
13541,13,0,0,0,0,0,84,13,71
13547,2006,180,123,43,8,13,18288,2373,15915
13549,2075,244,133,112,10,9,20136,2583,17553
13551,1321,150,151,21,15,34,14022,1692,12330
13553,2070,246,149,68,11,23,19932,2567,17365
13555,1915,245,181,84,22,39,19674,2486,17188
13576,400,53,34,11,15,16,3948,529,3419
13579,15,2,1,1,0,0,144,19,125
13581,177,20,10,8,4,1,1872,220,1652
13583,158,19,8,6,0,1,1518,192,1326
13585,212,12,14,4,4,1,2250,247,2003
13587,7,1,1,0,0,0,54,9,45
13589,4,0,0,0,0,0,30,4,26
13590,5,0,0,0,0,0,42,5,37
13592,8,0,0,1,0,0,66,9,57
13593,8,0,0,1,0,0,66,9,57
13632,155,15,5,5,1,0,1458,181,1277
13638,160,19,17,2,1,2,1764,201,1563
13641,10,0,2,0,0,0,114,12,102
13645,3,0,0,0,0,0,24,3,21
13646,108,15,8,14,1,0,1110,146,964
13650,258,26,25,5,3,7,2412,324,2088
13652,347,51,29,1,3,4,3474,435,3039
13654,9,2,2,0,0,0,78,13,65
13657,7,3,0,0,0,0,96,10,86
13664,1568,258,154,54,14,21,14490,2069,12421
13666,1577,214,197,65,18,22,15894,2093,13801
13668,2410,355,228,157,34,35,24354,3219,21135
13670,1682,216,125,67,20,38,16122,2148,13974
13672,2052,191,162,75,14,18,20190,2512,17678
13674,1559,192,141,58,11,22,16140,1983,14157
13676,927,150,118,50,8,11,9246,1264,7982
13678,1898,205,126,58,9,6,18204,2302,15902
13680,14,1,0,0,0,0,108,15,93
13682,161,19,5,6,0,0,1512,191,1321
13687,181,24,18,1,0,1,1782,225,1557
13696,5,0,0,0,0,0,72,5,67
13697,12,3,3,0,0,0,126,18,108
13699,216,16,9,5,1,0,2298,247,2051
13716,40,4,1,2,0,1,462,48,414
13720,337,36,25,4,0,1,3156,403,2753
13732,8,0,0,0,0,0,54,8,46
13735,13,0,0,0,0,0,84,13,71
13767,4,1,0,1,0,0,54,6,48
13768,18,2,3,1,0,0,168,24,144
13769,8,1,1,0,0,0,66,10,56
13773,427,63,28,10,1,3,4200,532,3668
13771,8,1,1,0,0,0,102,10,92
13772,9,1,1,0,0,2,102,13,89
13775,194,39,21,5,2,4,2334,265,2069
13777,329,24,20,14,2,2,3378,391,2987
13781,1208,135,127,66,18,28,12300,1582,10718
13783,1786,241,166,55,15,31,17328,2294,15034
13785,1849,270,178,51,23,14,18468,2385,16083
13787,1074,131,105,40,11,20,11280,1381,9899
13791,1241,162,143,50,8,15,12498,1619,10879
13793,1164,133,106,37,9,25,12282,1474,10808
13795,2048,285,193,101,21,57,20364,2705,17659
13797,2009,234,164,120,30,56,21792,2613,19179
13803,299,50,26,12,3,1,2742,391,2351
13805,12,0,0,0,0,0,108,12,96
13808,273,21,9,3,0,0,2568,306,2262
13810,162,21,14,4,2,1,1578,204,1374
13812,9,2,0,0,0,0,90,11,79
13813,15,3,1,0,0,0,132,19,113
13819,10,1,1,1,1,0,120,14,106
13823,155,17,10,7,2,0,1596,191,1405
13827,1051,94,56,17,7,11,10692,1236,9456
13835,6,0,0,0,0,0,78,6,72
13837,13,4,3,0,0,0,96,20,76
13840,66,7,3,3,0,0,714,79,635
13872,135,29,19,13,4,2,1746,202,1544
13876,12,0,0,2,0,0,114,14,100
13880,125,20,10,9,1,2,1356,167,1189
13886,142,9,8,0,3,0,1560,162,1398
13891,6,0,1,0,1,0,90,8,82
13892,1148,127,99,45,5,19,11202,1443,9759
13894,1424,117,105,50,12,30,12708,1738,10970
13896,1932,233,154,83,17,18,17496,2437,15059
13898,1600,194,147,66,23,31,15870,2061,13809
13900,588,73,61,17,14,5,5958,758,5200
13902,1629,225,186,62,15,22,17274,2139,15135
13904,1195,166,82,90,13,14,12852,1560,11292
13906,1661,239,207,30,17,26,16782,2180,14602
13908,114,13,14,5,6,1,1386,153,1233
13910,236,14,8,0,1,0,2454,259,2195
13914,321,37,30,17,4,7,3150,416,2734
13926,18,1,0,1,0,0,162,20,142
0,0,0,0,0,0,0,0,0,0
13951,491,50,30,4,2,1,4590,578,4012
13955,10,2,2,0,1,0,102,15,87
13958,558,106,51,19,3,6,5664,743,4921
13962,74,18,14,9,4,2,972,121,851
13964,8,4,3,3,1,0,150,19,131
13966,76,9,6,2,0,0,744,93,651
13974,11,1,1,0,0,0,108,13,95
13976,15,3,1,0,0,0,138,19,119
13978,8,2,1,0,0,0,72,11,61
13981,6,2,1,0,0,0,54,9,45
13999,1344,201,126,52,9,9,13044,1741,11303
14001,2109,215,157,40,10,2,18564,2533,16031
14003,1587,181,136,59,30,12,15282,2005,13277
14005,2304,316,245,109,24,15,23064,3013,20051
14009,1304,158,106,47,20,23,12774,1658,11116
14011,1330,129,106,38,9,18,12258,1630,10628
14015,142,30,10,9,4,0,1890,195,1695
14017,280,32,31,10,5,6,3120,364,2756
14035,260,47,41,7,2,5,2766,362,2404
14037,16,2,3,0,0,0,138,21,117
14041,14,1,1,0,1,1,156,18,138
14051,253,39,17,15,0,1,2262,325,1937
14053,9,4,1,0,0,0,102,14,88
14065,139,21,19,1,1,2,1170,183,987
14068,23,3,1,0,0,0,168,27,141
14069,72,5,5,5,1,1,864,89,775
14073,130,13,14,5,3,3,2034,168,1866
14090,4,1,0,1,0,0,42,6,36
14091,12,2,3,0,0,0,84,17,67
14094,1478,199,159,78,23,39,14712,1976,12736
14096,1183,224,154,94,16,22,12462,1693,10769
14098,2230,311,312,158,28,31,21444,3070,18374
14100,1881,196,116,61,18,12,17964,2284,15680
14102,1092,168,129,57,19,11,12150,1476,10674
14104,1444,202,138,65,14,13,14112,1876,12236
14106,1443,142,108,47,17,34,14058,1791,12267
14108,1833,199,157,52,20,21,18648,2282,16366
14110,315,50,28,22,0,2,2964,417,2547
14115,204,18,16,5,3,2,2268,248,2020
14118,270,61,24,4,5,6,2778,370,2408
14122,12,0,0,1,0,0,96,13,83
14123,196,20,14,2,7,2,1806,241,1565
14128,12,0,0,1,0,0,96,13,83
14130,7,2,2,0,0,0,78,11,67
14148,9,0,0,1,1,0,96,11,85
14150,13,3,1,0,0,0,108,17,91
14152,12,4,2,0,0,0,120,18,102
14156,66,3,0,13,4,0,708,86,622
14178,291,27,14,4,2,6,2826,344,2482
14180,8,4,2,0,0,0,72,14,58
14181,13,1,0,0,0,0,108,14,94
14183,6,0,0,1,0,1,66,8,58
14188,387,51,40,14,10,7,4176,509,3667
14190,159,18,11,6,3,0,1518,197,1321
14199,6,1,1,0,0,0,66,8,58
14200,1502,155,163,63,33,25,16026,1941,14085
14202,1661,164,129,49,20,14,15894,2037,13857
14204,1756,166,115,30,13,16,18132,2096,16036
14206,1738,213,180,25,54,47,16962,2257,14705
14219,155,10,5,3,0,4,1488,177,1311
14224,531,62,49,8,21,3,4872,674,4198
14230,51,5,1,2,0,0,564,59,505
14235,16,3,3,0,0,0,138,22,116
14237,14,2,2,0,0,0,120,18,102
14240,17,1,0,0,1,0,138,19,119
14241,7,1,0,0,1,0,78,9,69
14242,88,10,5,1,2,0,678,106,572
14248,85,12,12,0,0,0,678,109,569
14250,214,40,32,14,2,2,2652,304,2348
14252,6,1,1,0,0,0,66,8,58
14253,10,0,0,2,0,0,126,12,114
14262,565,95,48,7,11,3,5424,729,4695
14269,2,1,0,0,0,0,36,3,33
14274,297,38,25,2,1,5,2910,368,2542
14295,1,0,0,0,0,0,24,1,23
14300,5,0,0,0,0,0,48,5,43
14302,293,48,40,16,5,5,2904,407,2497
14321,187,14,10,5,0,0,1698,216,1482
14323,1811,184,162,86,29,38,17982,2310,15672
14325,1049,163,148,63,8,36,11544,1467,10077
14327,1322,196,128,39,15,34,13248,1734,11514
14329,1152,178,128,50,16,33,12750,1557,11193
14331,1357,185,127,57,11,43,13530,1780,11750
14333,1937,241,171,68,26,46,19296,2489,16807
14335,1916,229,173,87,8,17,18624,2430,16194
14337,102,9,4,0,4,0,1314,119,1195
14339,264,30,19,12,5,2,2580,332,2248
14351,232,51,31,15,5,3,2508,337,2171
14356,6,1,2,0,0,0,54,9,45
14357,4,1,1,0,0,0,66,6,60
14361,67,5,8,2,2,1,816,85,731
14363,159,31,12,10,1,4,1950,217,1733
14372,2,0,0,1,0,0,36,3,33
14373,2,0,1,1,1,0,36,5,31
14376,176,28,22,1,1,4,1998,232,1766
14378,318,34,23,8,7,0,3096,390,2706
14380,3,0,0,0,0,0,36,3,33
14383,4,1,1,0,0,0,72,6,66
14384,219,18,18,5,3,1,2340,264,2076
14386,3,0,0,0,0,0,24,3,21
14387,3,1,0,0,0,0,42,4,38
14388,408,39,33,14,5,3,3864,502,3362
14398,110,14,4,2,1,0,1080,131,949
14401,5,0,0,0,0,0,36,5,31
14424,1187,139,97,26,11,12,10608,1472,9136
14428,304,35,24,3,3,2,2844,371,2473
14430,1458,204,150,75,19,18,14088,1924,12164
14432,1878,258,185,134,27,34,18828,2516,16312
14434,1800,244,152,115,24,36,17778,2371,15407
14436,1531,199,145,78,19,22,15036,1994,13042
14438,1493,151,138,134,21,19,15294,1956,13338
14441,825,102,77,43,7,18,8346,1072,7274
14443,1416,247,109,84,18,16,14682,1890,12792
14445,923,96,83,57,23,19,9426,1201,8225
14447,1170,187,91,64,7,11,12456,1530,10926
14459,173,14,8,0,5,1,1572,201,1371
14468,5,0,0,0,0,0,48,5,43
14469,6,1,0,0,0,0,48,7,41
14470,293,34,26,4,5,1,2604,363,2241
14480,269,24,20,3,2,2,2790,320,2470
14489,109,13,11,4,3,3,1422,143,1279
14493,103,16,11,1,3,1,1104,135,969
0,0,0,0,0,0,0,0,0,0
14499,2,0,0,0,0,0,36,2,34
14502,346,35,19,4,5,4,3396,413,2983
14561,78,13,9,0,1,0,828,101,727
14566,507,57,54,8,12,1,4356,639,3717
14572,10,2,1,0,0,0,96,13,83
14574,16,4,3,0,0,0,120,23,97
14587,120,24,16,5,2,1,1326,168,1158
14592,15,6,5,0,0,1,126,27,99
14595,202,21,7,1,3,2,2166,236,1930
14604,4,1,0,0,0,0,42,5,37
14606,8,1,0,0,0,0,66,9,57
14611,1832,230,149,53,21,21,16704,2306,14398
14613,0,0,0,0,0,0,0,0,0
14615,1708,169,121,44,8,15,16542,2065,14477
14617,1096,143,125,45,8,13,10920,1430,9490
14619,1361,158,134,35,11,14,12480,1713,10767
14621,897,143,93,48,20,17,9756,1218,8538
14625,0,0,0,0,0,0,0,0,0
14631,175,8,7,1,1,0,1656,192,1464
14638,478,53,28,8,2,0,4572,569,4003
14679,12,0,1,0,0,0,96,13,83
14682,12,1,0,0,0,0,108,13,95
14683,13,3,2,0,0,0,102,18,84
14685,9,0,0,0,0,0,66,9,57
14695,276,28,16,6,2,2,2460,330,2130
14703,281,50,44,15,9,5,2694,404,2290
14717,1,2,1,0,0,0,30,4,26
14715,5,0,0,0,0,0,42,5,37
14725,173,30,17,2,2,0,1980,224,1756
0,0,0,0,0,0,0,0,0,0
14740,12,2,3,0,0,0,138,17,121
14750,6,0,1,0,0,0,60,7,53
14758,269,35,17,6,3,2,2712,332,2380
14771,1753,253,162,76,19,25,17526,2288,15238
14773,1330,166,114,35,5,16,12258,1666,10592
14775,1180,160,129,30,9,25,11226,1533,9693
14777,1403,192,151,85,36,41,13452,1908,11544
14783,882,118,99,40,10,21,9432,1170,8262
14785,1500,181,146,102,8,13,15294,1950,13344
14787,288,20,17,0,2,1,3030,328,2702
14793,204,25,11,23,2,2,2112,267,1845
14799,121,20,9,14,3,1,1518,168,1350
14805,10,2,1,1,1,0,120,15,105
14809,291,34,28,12,12,4,3138,381,2757
14812,7,0,0,0,1,0,84,8,76
14816,10,2,4,1,0,1,102,18,84
14817,12,0,0,0,0,0,114,12,102
14819,16,2,2,0,0,0,138,20,118
14840,305,30,25,6,3,3,3102,372,2730
14846,7,0,0,0,1,0,60,8,52
14847,12,0,0,1,1,0,126,14,112
14855,259,55,27,14,5,7,2766,367,2399
14861,129,23,12,4,0,0,1230,168,1062
14873,8,2,0,0,0,0,84,10,74
14874,145,22,14,13,7,2,1932,203,1729
14878,231,22,7,6,1,2,2310,269,2041
14881,1009,120,105,36,10,11,10278,1291,8987
14885,1639,204,181,80,24,15,15474,2143,13331
14887,1666,187,174,50,14,22,16200,2113,14087
14891,752,137,78,47,16,28,8352,1058,7294
14893,0,0,0,0,0,0,0,0,0
14903,410,52,34,12,11,5,4638,524,4114
14905,11,1,0,0,0,0,138,12,126
0,0,0,0,0,0,0,0,0,0
14910,239,39,33,2,2,0,2574,315,2259
14912,7,1,0,0,0,0,72,8,64
14927,222,21,18,5,1,6,2262,273,1989
14930,5,0,0,0,0,0,48,5,43
14933,6,1,0,1,0,0,66,8,58
14936,11,2,2,0,2,0,90,17,73
14951,194,28,39,15,6,1,1800,283,1517
14956,10,2,4,1,1,0,132,18,114
14957,18,3,1,1,1,0,138,24,114
14964,112,25,6,0,0,0,1206,143,1063
14967,6,1,0,0,0,0,54,7,47
14968,9,0,0,1,0,0,84,10,74
14971,324,53,51,8,12,14,3738,462,3276
14979,166,19,10,4,1,2,1812,202,1610
14984,3,1,0,0,0,0,42,4,38
14987,1015,155,122,35,12,16,10752,1355,9397
14993,97,8,5,1,0,0,924,111,813
14998,294,33,20,10,1,2,2844,360,2484
15003,162,25,14,5,3,0,1992,209,1783
15005,10,1,0,0,0,0,96,11,85
15008,7,4,3,1,0,0,108,15,93
15009,10,2,2,0,0,0,108,14,94
15013,3,2,0,2,0,0,78,7,71
15016,7,1,0,0,0,0,54,8,46
15040,258,28,26,6,3,2,2502,323,2179
0,0,0,0,0,0,0,0,0,0
15074,287,24,21,1,3,4,2640,340,2300
15076,74,11,3,1,0,1,900,90,810
0,0,0,0,0,0,0,0,0,0
15084,446,50,44,19,2,6,4542,567,3975
15092,12,1,1,0,0,0,114,14,100
15096,2228,236,177,93,18,24,21330,2776,18554
15098,1697,214,164,81,12,11,15666,2179,13487
15102,1922,217,173,65,26,15,18690,2418,16272
15104,0,0,0,0,0,0,0,0,0
15106,810,108,64,24,9,12,8118,1027,7091
15108,0,0,0,0,0,0,0,0,0
15110,1582,226,195,66,34,34,16134,2137,13997
15112,1373,174,157,71,15,15,13116,1805,11311
15117,75,9,9,2,0,0,672,95,577
15125,461,58,43,9,10,9,4296,590,3706
15129,625,64,49,12,17,3,6960,770,6190
15135,15,0,0,0,1,0,120,16,104
15137,10,1,1,0,1,0,132,13,119
15140,257,51,26,9,12,3,2892,358,2534
15147,63,8,7,0,0,1,678,79,599
15154,129,20,7,2,0,0,1308,158,1150
15163,95,25,14,1,2,1,954,138,816
15167,9,1,1,1,0,0,78,12,66
15171,241,40,17,5,3,1,2178,307,1871
15177,878,115,95,25,14,5,8196,1132,7064
15179,201,38,23,14,4,9,2766,289,2477
15181,0,0,0,0,0,0,0,0,0
15183,0,0,0,0,0,0,0,0,0
15185,1819,153,117,32,6,51,16746,2178,14568
15188,121,14,12,1,3,0,1116,151,965
15219,193,20,19,0,12,2,2166,246,1920
15223,11,2,0,0,0,0,102,13,89
15224,11,1,3,0,0,0,96,15,81
0,0,0,0,0,0,0,0,0,0
15252,312,31,15,11,6,7,3216,382,2834
15254,3,0,0,0,0,0,48,3,45
437,27,4,6,0,0,1,216,38,178
24,1415,173,131,38,16,11,13668,1784,11884
4778,18,4,6,1,0,0,168,29,139
4821,12,1,1,1,0,0,108,15,93
0,0,0,0,0,0,0,0,0,0
3569,212,22,13,4,1,1,2370,253,2117
5424,75,12,17,2,0,0,690,106,584
5374,13,2,1,0,0,0,102,16,86
5378,8,2,1,0,0,0,72,11,61
0,0,0,0,0,0,0,0,0,0
4978,12,2,2,0,0,1,114,17,97
459,21,0,0,1,0,1,204,23,181
551,313,33,20,2,3,2,2940,373,2567
4560,24,5,4,0,0,1,216,34,182
593,11,0,1,0,0,0,96,12,84
778,11,1,0,0,0,0,90,12,78
5336,18,4,2,0,0,0,150,24,126
5333,18,3,2,1,0,0,162,24,138
767,4,0,0,0,0,0,42,4,38
782,15,1,2,0,0,0,132,18,114
4559,11,0,0,0,2,0,96,13,83
797,19,1,2,1,1,0,162,24,138
4822,17,1,0,0,1,0,132,19,113
830,7,1,1,0,0,0,60,9,51
854,7,2,2,0,1,0,84,12,72
860,7,2,2,0,1,0,84,12,72
898,3,0,0,0,0,1,42,4,38
925,9,0,0,0,0,0,78,9,69
969,12,2,1,0,0,0,144,15,129
4993,97,6,9,3,0,1,876,116,760
1054,22,1,2,2,1,0,174,28,146
1069,4,1,0,1,0,1,72,7,65
1072,7,0,0,1,0,0,102,8,94
4810,24,2,2,1,0,0,186,29,157
5232,6,1,1,0,0,0,66,8,58
5236,9,2,1,1,2,0,102,15,87
5229,8,1,0,0,0,0,66,9,57
0,0,0,0,0,0,0,0,0,0
4731,7,0,0,1,0,0,78,8,70
4601,322,55,33,16,4,4,4386,434,3952
1184,19,1,1,0,0,0,138,21,117
0,0,0,0,0,0,0,0,0,0
5172,15,2,1,1,0,0,162,19,143
0,0,0,0,0,0,0,0,0,0
1472,265,29,26,4,1,8,2538,333,2205
1508,163,7,7,2,1,0,1578,180,1398
5288,6,0,0,0,0,0,60,6,54
5291,9,1,0,0,0,0,78,10,68
5273,14,0,0,0,0,1,132,15,117
0,0,0,0,0,0,0,0,0,0
4888,6,2,2,0,0,0,78,10,68
4889,6,2,2,0,0,0,72,10,62
4781,11,1,1,0,0,0,96,13,83
4782,411,66,46,9,1,4,4014,537,3477
1630,11,3,1,0,0,0,102,15,87
1648,3,0,0,0,0,0,30,3,27
1652,10,1,1,1,0,0,90,13,77
4949,2,2,1,0,0,0,48,5,43
4950,27,6,2,0,0,0,204,35,169
4951,8,2,1,0,0,0,66,11,55
0,0,0,0,0,0,0,0,0,0
4953,16,3,2,0,0,0,120,21,99
4955,21,3,3,0,0,0,174,27,147
5109,20,2,1,2,0,0,180,25,155
5110,13,0,0,0,0,0,126,13,113
5130,13,3,1,0,0,0,120,17,103
1807,7,0,0,0,0,0,66,7,59
1731,11,0,0,0,0,0,114,11,103
1748,278,31,27,5,1,0,2562,342,2220
5151,15,0,0,0,0,0,132,15,117
1811,2,0,0,0,0,0,30,2,28
3832,807,91,49,11,14,3,7812,975,6837
3749,91,11,6,1,2,0,1086,111,975
5100,7,1,0,1,0,0,54,9,45
5102,14,2,0,0,0,0,102,16,86
1849,13,1,0,1,0,0,120,15,105
5082,17,3,2,0,0,1,138,23,115
5081,16,2,1,1,0,0,144,20,124
5065,10,2,2,1,1,0,102,16,86
1912,12,0,1,0,0,0,102,13,89
4796,2,1,0,0,0,0,42,3,39
4901,9,2,1,0,0,0,72,12,60
4903,9,0,0,0,0,0,72,9,63
4904,8,1,2,0,0,0,78,11,67
4905,15,1,1,0,1,0,108,18,90
4906,8,0,0,0,0,0,78,8,70
4907,10,2,1,0,0,0,78,13,65
4910,3,0,0,0,0,0,36,3,33
5040,12,2,2,0,0,0,114,16,98
5028,10,2,0,0,0,1,102,13,89
5029,15,2,0,0,0,0,120,17,103
5034,14,2,2,0,0,0,144,18,126
5024,5,0,0,0,0,1,48,6,42
5027,7,4,2,1,1,0,84,15,69
5003,17,2,3,0,1,0,138,23,115
5043,353,20,16,5,1,0,3612,395,3217
4998,18,2,0,0,0,0,174,20,154
4999,6,3,2,1,0,0,72,12,60
5000,12,1,0,0,0,0,108,13,95
5001,8,3,3,0,0,2,114,16,98
4913,12,2,1,1,0,0,114,16,98
4960,9,2,1,0,0,0,72,12,60
1985,11,1,1,0,0,0,84,13,71
4921,8,2,2,0,0,0,108,12,96
4923,11,0,0,1,0,1,90,13,77
2018,187,13,11,6,0,0,2202,217,1985
2024,6,1,0,0,0,0,66,7,59
2026,16,2,0,3,0,0,144,21,123
4892,4,1,1,0,0,0,42,6,36
4894,13,3,1,0,0,0,108,17,91
4895,8,0,0,0,0,0,66,8,58
4896,17,1,2,0,0,0,138,20,118
4791,12,1,4,0,0,0,114,17,97
4792,6,0,0,0,0,0,54,6,48
4793,9,1,1,0,0,0,66,11,55
4794,11,2,1,0,0,0,96,14,82
2143,13,1,1,0,0,0,120,15,105
2145,25,2,1,1,0,0,264,29,235
2147,19,0,3,1,0,0,198,23,175
2170,11,2,1,0,0,0,90,14,76
2252,3,0,0,0,0,0,36,3,33
2280,4,0,1,0,0,0,48,5,43
2284,7,0,0,0,0,0,66,7,59
2289,12,2,1,1,2,0,120,18,102
2989,7,3,0,0,0,0,72,10,62
3071,24,2,0,1,0,0,210,27,183
4020,4,0,1,0,0,0,54,5,49
2941,12,2,3,2,0,0,150,19,131
0,0,0,0,0,0,0,0,0,0
0,0,0,0,0,0,0,0,0,0
3616,233,34,22,9,2,3,2706,303,2403
3099,18,4,3,0,0,0,126,25,101
3086,12,0,0,0,0,0,108,12,96
3999,20,1,1,0,0,0,162,22,140
2471,14,2,1,0,1,0,126,18,108
2477,20,4,3,0,0,0,174,27,147
2479,20,0,0,0,0,0,132,20,112
2503,9,3,1,0,0,0,96,13,83
2505,17,2,0,0,0,0,132,19,113
2510,12,2,2,1,0,0,114,17,97
4003,3,0,1,0,0,0,48,4,44
3282,205,28,13,1,0,2,1992,249,1743
2647,5,2,0,0,0,0,60,7,53
3596,3,0,0,0,0,0,36,3,33
2663,6,1,0,1,0,1,66,9,57
4006,20,0,0,1,0,0,162,21,141
2669,11,0,1,1,0,0,108,13,95
2703,17,2,2,0,0,0,150,21,129
2708,6,1,0,0,0,0,60,7,53
2710,7,0,0,0,0,0,84,7,77
2712,9,1,1,0,0,0,90,11,79
2714,10,1,0,0,0,0,114,11,103
2718,9,1,1,1,0,0,102,12,90
2754,191,16,18,4,4,0,1746,233,1513
2796,10,2,1,0,0,0,120,13,107
2800,7,2,0,1,0,0,72,10,62
5346,9,0,0,0,0,0,96,9,87
5348,15,1,0,0,0,0,144,16,128
5167,980,120,89,9,5,12,9474,1215,8259
3035,7,1,1,0,0,0,66,9,57
3049,6,0,1,0,0,0,48,7,41
3065,405,37,20,5,3,1,3690,471,3219
3426,19,1,2,1,0,0,156,23,133
3461,12,2,1,0,0,0,126,15,111
3463,13,0,0,0,0,0,102,13,89
3491,207,23,18,7,2,0,1842,257,1585
3474,4,1,1,1,0,0,60,7,53
3473,12,1,1,0,0,0,126,14,112
3502,5,0,0,0,0,0,90,5,85
3503,6,0,0,0,0,1,72,7,65
0,0,0,0,0,0,0,0,0,0
3507,12,2,1,1,1,0,126,17,109
3508,11,3,0,0,0,0,102,14,88
3511,10,1,0,0,0,0,102,11,91
3656,140,17,13,4,1,3,1602,178,1424
0,0,0,0,0,0,0,0,0,0
3643,2414,223,176,74,17,7,22902,2911,19991
3635,486,62,50,29,1,6,5010,634,4376
3637,5,1,0,0,0,0,102,6,96
3661,155,26,17,5,0,1,1596,204,1392
3699,12,0,0,0,0,0,102,12,90
3702,10,1,1,0,0,0,90,12,78
3703,9,1,0,0,1,0,90,11,79
3704,11,2,1,0,1,0,96,15,81
3707,90,7,4,6,1,2,984,110,874
3731,281,43,19,5,3,2,2856,353,2503
3844,451,37,32,4,3,2,4050,529,3521
3857,1716,224,142,73,24,22,16494,2201,14293
3873,53,4,2,0,2,0,606,61,545
3880,124,18,11,3,1,0,2190,157,2033
3904,95,7,5,0,0,0,774,107,667
3923,14,0,0,0,0,0,102,14,88
3955,574,73,59,29,1,2,5274,738,4536
3925,4,0,1,0,0,0,36,5,31
3928,6,1,3,0,1,0,66,11,55
3945,12,0,1,0,0,0,120,13,107
3953,70,5,7,0,0,1,798,83,715
3961,10,0,0,0,0,0,72,10,62
3963,15,1,0,0,0,0,144,16,128
3964,17,5,4,1,0,0,150,27,123
3965,25,2,2,1,0,0,180,30,150
3966,10,1,1,1,0,0,96,13,83
3967,10,1,1,1,0,0,96,13,83
3968,16,1,1,0,0,0,150,18,132
3972,9,0,0,1,0,0,96,10,86
0,0,0,0,0,0,0,0,0,0
0,0,0,0,0,0,0,0,0,0
3987,284,31,20,8,2,2,2508,347,2161
4021,23,4,5,0,0,0,198,32,166
4022,23,4,5,0,0,0,198,32,166
4023,9,1,2,1,0,0,90,13,77
4025,419,34,19,12,3,0,4722,487,4235
4033,38,3,5,0,1,1,354,48,306
4040,254,21,10,4,2,2,2472,293,2179
4045,11,0,1,0,0,0,78,12,66
4046,6,0,1,2,0,0,78,9,69
4047,9,0,0,0,0,0,102,9,93
4048,8,3,2,1,0,0,114,14,100
4049,8,3,2,1,0,0,114,14,100
4050,16,1,0,0,0,0,126,17,109
4052,3,1,1,0,1,0,36,6,30
4054,13,1,0,0,0,0,102,14,88
4071,18,2,2,1,0,0,174,23,151
4072,10,2,1,0,0,0,120,13,107
4073,10,1,1,0,0,0,90,12,78
4074,6,0,0,1,0,0,54,7,47
4075,6,1,2,0,0,0,72,9,63
4126,8,2,2,0,0,0,78,12,66
4128,12,2,1,0,0,0,126,15,111
4130,8,0,0,0,0,0,90,8,82
4132,13,1,1,0,0,0,138,15,123
4135,4,1,0,0,0,0,66,5,61
4135,4,1,0,0,0,0,66,5,61
4137,11,2,1,0,0,1,156,15,141
4138,9,0,0,0,0,0,72,9,63
4139,12,2,2,0,1,1,144,18,126
4141,8,3,0,0,1,0,96,12,84
4145,6,2,0,0,0,0,96,8,88
4148,6,0,1,0,0,0,66,7,59
4149,19,3,1,0,0,0,216,23,193
4187,4,0,0,0,0,0,54,4,50
4188,8,1,2,1,1,1,90,14,76
4189,19,5,4,1,0,0,162,29,133
4191,15,2,2,2,0,0,138,21,117
4194,4,0,0,0,0,0,42,4,38
15196,28,1,3,0,0,0,216,32,184
6427,5,2,1,0,0,0,60,8,52
4251,14,4,0,0,1,0,144,19,125
4256,12,3,3,2,0,0,132,20,112
4257,23,3,1,0,0,0,216,27,189
4259,25,5,2,0,1,0,222,33,189
4303,208,24,10,9,0,0,2136,251,1885
4309,9,0,0,1,0,0,78,10,68
4314,18,3,6,0,0,0,180,27,153
4317,10,0,0,0,0,0,72,10,62
4318,8,0,3,1,0,0,150,12,138
4319,11,1,1,0,0,0,138,13,125
4320,11,1,0,1,0,0,102,13,89
4322,19,3,2,0,0,0,150,24,126
4324,11,0,0,0,0,1,96,12,84
4374,5,0,0,1,0,0,42,6,36
4389,13,2,3,0,0,0,114,18,96
4396,10,2,2,0,0,0,78,14,64
4402,7,0,0,0,0,0,72,7,65
4405,4,0,3,0,0,0,60,7,53
4407,5,1,1,0,0,0,60,7,53
4408,4,1,0,0,0,0,60,5,55
4409,4,1,0,0,0,0,54,5,49
4410,9,2,2,0,0,0,66,13,53
4411,5,0,1,0,0,0,60,6,54
4413,2,0,0,1,0,0,48,3,45
4415,6,1,1,0,1,0,66,9,57
0,0,0,0,0,0,0,0,0,0
4418,9,1,1,0,1,0,72,12,60
4419,5,2,1,0,0,1,54,9,45
4434,11,0,1,0,0,0,96,12,84
4435,8,1,0,0,0,1,102,10,92
4485,5,0,0,0,0,0,60,5,55
4472,7,0,0,0,0,0,48,7,41
4473,7,2,1,0,0,0,72,10,62
4474,10,1,1,0,0,0,84,12,72
4479,8,3,3,0,0,0,90,14,76
4507,12,1,1,0,0,1,108,15,93
4510,9,1,0,1,0,0,84,11,73
4511,7,0,1,0,0,0,60,8,52
4512,7,3,1,0,0,0,78,11,67
4513,13,1,1,0,0,0,96,15,81
4514,10,3,2,0,0,0,90,15,75
4515,10,3,2,0,0,0,90,15,75
4540,9,0,0,0,0,0,90,9,81
4546,11,0,0,0,0,0,78,11,67
4547,11,2,1,1,1,0,126,16,110
4549,8,2,1,0,1,0,90,12,78
4550,4,0,0,0,0,0,72,4,68
4552,6,2,2,0,0,0,84,10,74
4638,10,1,1,0,0,0,102,12,90
4586,63,6,2,3,2,0,654,76,578
4611,8,0,0,0,0,0,90,8,82
4615,11,2,2,0,0,0,102,15,87
4618,15,2,2,1,0,0,132,20,112
4621,12,3,1,0,0,0,114,16,98
4639,5,0,0,0,0,0,42,5,37
4640,10,1,1,1,0,0,120,13,107
4642,7,0,0,0,0,1,84,8,76
4643,5,0,0,0,0,0,66,5,61
4644,12,1,2,1,0,0,126,16,110
4684,539,47,24,8,3,1,4680,622,4058
4647,5,0,0,0,0,0,54,5,49
4671,11,1,1,0,0,0,132,13,119
4675,10,2,2,1,0,0,114,15,99
4676,9,2,2,0,1,0,114,14,100
4890,9,0,1,0,0,0,108,10,98
4774,16,5,4,1,0,0,144,26,118
4744,11,5,2,1,0,0,126,19,107
4746,16,1,2,0,0,1,150,20,130
4747,16,1,2,0,0,1,150,20,130
4748,12,1,0,0,0,0,96,13,83
4749,4,1,0,0,0,0,36,5,31
4771,11,0,0,0,0,0,78,11,67
4773,3,0,0,0,0,0,24,3,21
4806,15,1,0,0,0,0,138,16,122
4814,9,2,0,1,0,1,96,13,83
4815,13,1,1,0,0,0,96,15,81
4818,6,1,1,0,0,0,78,8,70
4845,636,46,39,4,5,1,6306,731,5575
5602,11,1,0,3,0,0,108,15,93
5611,15,1,1,3,0,0,120,20,100
5858,11,1,0,0,1,0,102,13,89
5859,7,2,2,0,0,0,72,11,61
5887,9,0,0,0,0,0,66,9,57
5891,58,7,7,0,0,0,606,72,534
5893,125,41,30,4,3,8,1638,211,1427
5915,8,2,2,0,0,0,114,12,102
5916,5,0,1,0,0,0,72,6,66
5921,11,0,0,0,0,0,102,11,91
5928,15,2,1,1,0,0,126,19,107
5929,18,3,1,0,0,0,138,22,116
5949,15,0,0,0,0,0,120,15,105
5954,15,1,1,1,0,0,156,18,138
5960,9,0,1,1,0,1,126,12,114
5985,4,1,0,0,0,0,48,5,43
5994,16,3,3,0,0,0,132,22,110
6017,13,2,0,0,0,0,108,15,93
6020,11,0,1,1,0,1,120,14,106
6046,80,11,11,1,0,0,624,103,521
6057,11,3,2,0,0,2,132,18,114
6059,10,1,0,0,0,1,102,12,90
6065,16,5,1,0,0,0,126,22,104
6089,8,0,0,1,0,1,72,10,62
6182,241,21,17,8,1,4,2208,292,1916
6118,5,1,0,0,0,0,54,6,48
6123,3,2,1,1,0,1,90,8,82
6124,11,2,2,1,0,1,138,17,121
6146,13,1,0,0,0,0,126,14,112
6150,11,2,0,0,0,0,114,13,101
6180,10,0,0,0,1,0,84,11,73
6181,7,3,1,0,0,0,72,11,61
6201,226,22,8,7,2,0,2142,265,1877
6212,281,34,24,8,7,4,2958,358,2600
6234,6,1,1,0,0,1,66,9,57
6241,5,0,0,3,0,0,42,8,34
6242,135,6,9,3,9,0,1452,162,1290
6266,7,1,0,0,0,0,78,8,70
6267,6,1,1,0,0,0,78,8,70
6270,0,0,0,0,0,0,12,0,12
6294,8,2,0,1,0,0,114,11,103
6296,7,1,0,0,0,0,84,8,76
6300,9,0,1,0,0,0,102,10,92
6307,6,1,0,0,0,0,78,7,71
6308,11,3,0,0,0,0,150,14,136
6309,20,1,1,0,0,0,168,22,146
6310,16,3,1,1,0,0,162,21,141
6311,16,3,1,1,0,0,162,21,141
6336,12,2,1,0,0,0,126,15,111
6339,12,1,0,0,0,0,108,13,95
6344,9,4,1,1,0,0,138,15,123
6346,13,1,0,1,2,0,132,17,115
6347,13,1,0,1,2,0,132,17,115
6352,8,1,0,0,1,0,90,10,80
6359,8,1,1,0,0,0,84,10,74
6361,18,2,1,0,0,0,156,21,135
6374,9,1,0,1,0,0,90,11,79
6381,14,3,2,1,0,1,156,21,135
6406,13,0,2,0,0,1,132,16,116
6407,6,2,2,0,1,0,96,11,85
6410,12,2,3,0,0,0,132,17,115
6411,16,1,0,0,0,0,150,17,133
6415,12,1,2,0,0,0,120,15,105
6417,15,2,0,1,0,0,162,18,144
6419,6,1,1,0,0,0,78,8,70
6442,285,18,15,3,2,0,2742,323,2419
6449,3,1,0,0,0,0,30,4,26
6472,24,0,0,0,1,0,240,25,215
6493,5,1,0,0,0,0,60,6,54
6495,16,2,2,0,0,1,144,21,123
6497,3,0,0,0,0,0,42,3,39
6498,18,5,8,0,0,1,168,32,136
6500,16,4,2,0,0,0,138,22,116
6501,15,0,0,0,0,0,132,15,117
6502,14,0,0,0,0,1,120,15,105
6517,5,0,0,0,0,0,54,5,49
6539,7,3,1,0,0,0,96,11,85
6540,8,0,0,0,2,0,96,10,86
6541,18,2,0,1,0,0,156,21,135
6542,18,2,0,1,0,0,156,21,135
6543,18,2,0,1,0,0,156,21,135
6546,4,0,1,0,0,0,54,5,49
0,0,0,0,0,0,0,0,0,0
0,0,0,0,0,0,0,0,0,0
0,0,0,0,0,0,0,0,0,0
0,0,0,0,0,0,0,0,0,0
0,0,0,0,0,0,0,0,0,0
6613,15,3,3,0,1,1,156,23,133
6614,11,2,3,0,0,0,108,16,92
6615,11,2,3,0,0,0,108,16,92
6616,7,1,1,2,0,0,96,11,85
6618,4,0,1,0,1,0,78,6,72
0,0,0,0,0,0,0,0,0,0
0,0,0,0,0,0,0,0,0,0
0,0,0,0,0,0,0,0,0,0
6649,26,1,1,0,0,0,198,28,170
6656,6,2,1,0,0,0,72,9,63
6682,20,0,0,2,0,1,144,23,121
6683,1,0,0,0,0,0,12,1,11
0,0,0,0,0,0,0,0,0,0
6699,564,46,36,13,7,6,5502,672,4830
6703,8,1,2,0,0,0,84,11,73
6705,13,4,2,1,0,0,126,20,106
6708,17,4,2,1,0,0,168,24,144
6711,9,0,0,1,0,0,84,10,74
6715,15,0,0,0,0,0,138,15,123
6721,6,4,3,1,1,2,114,17,97
0,0,0,0,0,0,0,0,0,0
0,0,0,0,0,0,0,0,0,0
6801,15,1,0,1,0,0,150,17,133
6806,19,3,3,0,0,1,168,26,142
6825,123,16,6,8,1,3,1320,157,1163
0,0,0,0,0,0,0,0,0,0
0,0,0,0,0,0,0,0,0,0
8550,17,2,1,0,0,0,138,20,118
8551,17,2,1,0,0,0,138,20,118
0,0,0,0,0,0,0,0,0,0
6856,150,3,1,3,0,0,1272,157,1115
6863,12,1,0,0,0,0,132,13,119
6864,12,2,1,0,0,0,114,15,99
6865,19,0,0,0,0,0,138,19,119
0,0,0,0,0,0,0,0,0,0
6894,9,2,0,0,0,0,102,11,91
6895,11,2,1,0,0,0,114,14,100
6896,5,0,0,0,0,0,42,5,37
0,0,0,0,0,0,0,0,0,0
6904,119,30,21,6,1,3,1422,180,1242
0,0,0,0,0,0,0,0,0,0
6919,14,1,2,1,1,0,156,19,137
6921,714,100,32,10,10,4,6780,870,5910
6924,13,3,1,0,0,0,126,17,109
6927,8,0,0,0,0,0,96,8,88
0,0,0,0,0,0,0,0,0,0
0,0,0,0,0,0,0,0,0,0
6961,8,0,0,0,0,0,66,8,58
0,0,0,0,0,0,0,0,0,0
6974,9,1,2,0,0,1,90,13,77
6975,7,1,1,3,0,0,72,12,60
6976,16,2,2,0,0,0,114,20,94
6978,7,1,2,1,0,0,54,11,43
6980,13,1,0,1,0,0,108,15,93
6981,11,4,3,0,0,0,114,18,96
0,0,0,0,0,0,0,0,0,0
0,0,0,0,0,0,0,0,0,0
0,0,0,0,0,0,0,0,0,0
7023,396,51,39,12,0,1,4422,499,3923
7026,10,1,1,0,0,0,108,12,96
7027,188,12,10,7,2,1,1818,220,1598
7050,15,0,0,0,0,0,108,15,93
7054,3,1,0,0,0,0,36,4,32
7055,15,2,1,1,0,1,132,20,112
7056,6,1,1,0,0,0,60,8,52
7058,8,1,1,0,0,0,60,10,50
0,0,0,0,0,0,0,0,0,0
0,0,0,0,0,0,0,0,0,0
7088,4,0,0,0,0,0,36,4,32
0,0,0,0,0,0,0,0,0,0
7120,357,33,25,12,3,4,3546,434,3112
7123,17,2,2,0,0,0,114,21,93
7124,6,1,1,0,0,0,48,8,40
7139,1,0,0,1,0,0,150,2,148
7143,19,3,4,0,0,0,162,26,136
7144,9,1,0,0,0,0,72,10,62
7147,15,4,1,0,0,0,156,20,136
0,0,0,0,0,0,0,0,0,0
0,0,0,0,0,0,0,0,0,0
7182,101,12,12,0,1,1,1038,127,911
7191,11,2,1,0,0,0,102,14,88
7198,9,1,1,0,0,0,66,11,55
7238,606,58,42,17,8,6,5484,737,4747
7240,7,0,0,0,0,0,60,7,53
7246,8,3,1,0,0,0,72,12,60
7247,7,1,1,0,0,0,78,9,69
0,0,0,0,0,0,0,0,0,0
0,0,0,0,0,0,0,0,0,0
0,0,0,0,0,0,0,0,0,0
0,0,0,0,0,0,0,0,0,0
0,0,0,0,0,0,0,0,0,0
0,0,0,0,0,0,0,0,0,0
0,0,0,0,0,0,0,0,0,0
0,0,0,0,0,0,0,0,0,0
7373,9,2,1,0,0,1,96,13,83
7377,10,0,0,0,0,0,78,10,68
7382,11,2,1,1,1,0,126,16,110
7383,19,1,1,0,0,0,156,21,135
7384,19,1,1,0,0,0,156,21,135
7387,5,1,1,0,0,0,60,7,53
7390,15,2,1,1,0,0,150,19,131
7391,5,1,0,0,0,0,54,6,48
0,0,0,0,0,0,0,0,0,0
0,0,0,0,0,0,0,0,0,0
8419,6,2,1,1,0,0,66,10,56
0,0,0,0,0,0,0,0,0,0
7438,12,2,2,0,0,0,132,16,116
7454,16,2,1,1,0,0,144,20,124
0,0,0,0,0,0,0,0,0,0
0,0,0,0,0,0,0,0,0,0
7498,7,0,0,0,0,0,66,7,59
7501,1,1,1,0,0,0,30,3,27
7506,13,3,2,0,0,0,144,18,126
7508,11,4,3,0,0,1,90,19,71
7511,8,1,2,0,0,0,84,11,73
7512,6,0,1,0,0,0,90,7,83
7517,3,0,0,0,0,0,24,3,21
7519,13,4,1,0,0,0,120,18,102
0,0,0,0,0,0,0,0,0,0
0,0,0,0,0,0,0,0,0,0
7563,231,56,29,10,1,7,2712,334,2378
7568,13,2,1,2,0,0,132,18,114
7569,4,1,1,0,0,1,66,7,59
7575,8,2,1,2,0,0,90,13,77
7578,5,1,1,2,0,0,60,9,51
7579,8,1,2,0,0,0,114,11,103
7580,5,1,1,0,0,0,36,7,29
7586,5,0,0,0,0,0,42,5,37
7588,8,0,0,0,0,0,66,8,58
0,0,0,0,0,0,0,0,0,0
0,0,0,0,0,0,0,0,0,0
0,0,0,0,0,0,0,0,0,0
8401,321,44,26,11,5,9,2982,416,2566
7630,5,0,0,0,0,0,48,5,43
7631,105,11,7,3,1,1,1314,128,1186
7652,3,0,1,0,0,0,42,4,38
7654,4,0,1,0,0,0,42,5,37
7655,14,1,0,0,1,0,126,16,110
7656,16,2,1,0,0,0,138,19,119
7657,11,3,2,0,0,0,96,16,80
7668,9,2,0,1,2,1,138,15,123
7671,14,1,1,0,0,0,114,16,98
7673,9,1,0,0,0,0,90,10,80
0,0,0,0,0,0,0,0,0,0
7683,6,1,0,0,0,0,72,7,65
7684,5,2,0,0,1,1,66,9,57
7703,13,0,0,0,0,0,114,13,101
7709,1,0,0,0,0,0,18,1,17
7710,496,53,47,6,10,3,5304,615,4689
7717,11,2,1,0,0,0,138,14,124
7719,5,0,0,0,0,0,42,5,37
7721,851,69,36,19,6,18,8064,999,7065
7732,18,0,2,0,0,0,150,20,130
7734,14,2,0,0,0,0,108,16,92
7749,7,1,0,0,0,0,60,8,52
7750,68,12,3,4,0,0,804,87,717
7760,13,1,0,0,0,0,102,14,88
0,0,0,0,0,0,0,0,0,0
0,0,0,0,0,0,0,0,0,0
0,0,0,0,0,0,0,0,0,0
0,0,0,0,0,0,0,0,0,0
0,0,0,0,0,0,0,0,0,0
0,0,0,0,0,0,0,0,0,0
0,0,0,0,0,0,0,0,0,0
0,0,0,0,0,0,0,0,0,0
0,0,0,0,0,0,0,0,0,0
0,0,0,0,0,0,0,0,0,0
7860,3,2,0,0,0,0,48,5,43
7861,169,12,17,3,0,0,1530,201,1329
7864,7,0,0,0,0,0,72,7,65
7870,13,3,2,1,0,0,156,19,137
7873,295,42,33,18,4,2,3888,394,3494
7878,7,0,2,1,0,1,90,11,79
7900,7,2,0,1,0,0,78,10,68
7902,10,2,1,2,1,1,114,17,97
7903,17,3,3,2,0,1,156,26,130
7905,237,24,20,4,1,0,2514,286,2228
7911,12,2,0,1,0,1,120,16,104
7912,11,2,3,1,0,0,90,17,73
7915,4,0,1,0,1,0,90,6,84
7916,15,1,1,0,1,0,126,18,108
7917,15,2,1,0,0,0,132,18,114
7919,10,2,1,0,0,0,114,13,101
7938,9,0,0,1,0,0,114,10,104
7939,4,1,1,0,0,0,78,6,72
7940,11,2,2,0,1,1,114,17,97
7943,2,0,0,0,0,0,18,2,16
7945,2,0,0,1,0,0,24,3,21
7946,3,0,0,0,0,0,24,3,21
7948,4,0,1,0,0,0,54,5,49
7949,2,0,0,0,0,0,24,2,22
7953,301,59,25,14,6,8,3264,413,2851
7975,6,0,2,0,0,0,84,8,76
7983,3,0,0,1,0,0,60,4,56
7987,104,14,11,3,0,0,912,132,780
7989,21,3,3,1,0,0,180,28,152
7991,13,0,1,0,0,0,108,14,94
0,0,0,0,0,0,0,0,0,0
0,0,0,0,0,0,0,0,0,0
0,0,0,0,0,0,0,0,0,0
0,0,0,0,0,0,0,0,0,0
0,0,0,0,0,0,0,0,0,0
0,0,0,0,0,0,0,0,0,0
0,0,0,0,0,0,0,0,0,0
0,0,0,0,0,0,0,0,0,0
0,0,0,0,0,0,0,0,0,0
0,0,0,0,0,0,0,0,0,0
0,0,0,0,0,0,0,0,0,0
8091,453,41,26,13,3,1,4614,537,4077
8093,17,4,2,0,0,0,126,23,103
8095,13,2,0,1,0,0,144,16,128
8096,11,2,2,0,0,0,126,15,111
8097,10,1,1,0,0,0,96,12,84
8098,2,1,0,0,0,0,30,3,27
8099,5,2,1,0,1,0,60,9,51
8102,16,2,1,0,0,0,120,19,101
8103,16,2,1,0,0,0,120,19,101
8104,17,1,2,0,0,0,126,20,106
8105,4,1,0,0,0,0,48,5,43
8109,11,0,0,0,0,0,102,11,91
8112,6,1,0,1,0,0,72,8,64
8113,8,1,1,1,0,0,114,11,103
8114,7,0,0,0,0,0,78,7,71
8116,15,0,0,0,1,0,150,16,134
8122,11,1,2,0,0,0,132,14,118
8128,8,2,1,1,0,0,78,12,66
8165,5,0,1,0,0,0,60,6,54
8185,15,1,2,0,0,0,120,18,102
8186,5,0,0,0,0,0,48,5,43
8187,19,5,3,1,0,0,168,28,140
8189,18,5,3,0,0,0,228,26,202
8191,23,3,1,1,0,0,186,28,158
8194,12,1,1,0,1,0,126,15,111
8195,18,4,2,0,0,0,168,24,144
8198,4,0,0,0,0,0,42,4,38
0,0,0,0,0,0,0,0,0,0
8212,7,0,0,0,0,0,54,7,47
0,0,0,0,0,0,0,0,0,0
0,0,0,0,0,0,0,0,0,0
0,0,0,0,0,0,0,0,0,0
0,0,0,0,0,0,0,0,0,0
0,0,0,0,0,0,0,0,0,0
8251,87,9,11,5,3,1,936,116,820
8253,13,2,2,2,1,0,168,20,148
8262,6,0,0,0,0,0,42,6,36
8264,6,1,2,0,0,0,96,9,87
8269,5,1,0,0,0,0,60,6,54
8282,3,0,0,0,0,0,24,3,21
8287,16,0,0,1,0,0,126,17,109
8288,7,0,0,0,2,1,72,10,62
8296,7,1,0,0,0,1,66,9,57
8298,19,2,1,0,0,0,144,22,122
8301,15,0,1,1,0,0,150,17,133
8303,20,2,2,0,0,0,144,24,120
8305,3,1,0,0,0,0,48,4,44
0,0,0,0,0,0,0,0,0,0
0,0,0,0,0,0,0,0,0,0
8316,12,1,1,1,0,0,132,15,117
0,0,0,0,0,0,0,0,0,0
0,0,0,0,0,0,0,0,0,0
8331,11,2,1,0,0,0,102,14,88
8334,11,0,0,0,1,0,90,12,78
8335,136,17,17,4,3,2,1512,179,1333
8337,10,1,1,0,0,1,102,13,89
8339,477,35,31,6,3,4,4248,556,3692
8342,19,1,0,0,0,0,162,20,142
8343,19,1,0,0,0,0,162,20,142
8348,7,0,0,0,0,0,78,7,71
8352,14,2,2,1,0,0,132,19,113
8353,6,0,0,0,0,0,54,6,48
8354,8,3,1,0,0,0,90,12,78
8356,15,0,0,0,0,1,132,16,116
8357,6,0,0,0,0,0,72,6,66
8360,8,2,0,0,0,0,90,10,80
0,0,0,0,0,0,0,0,0,0
0,0,0,0,0,0,0,0,0,0
0,0,0,0,0,0,0,0,0,0
0,0,0,0,0,0,0,0,0,0
0,0,0,0,0,0,0,0,0,0
8405,20,3,2,1,1,0,216,27,189
8407,8,0,0,0,0,0,60,8,52
8410,16,0,0,1,0,0,126,17,109
8413,19,1,2,0,0,0,180,22,158
8414,3,2,0,0,0,0,78,5,73
8420,8,1,1,0,0,0,108,10,98
8421,6,1,0,1,0,0,78,8,70
8447,12,0,0,0,0,0,102,12,90
8452,583,35,25,6,4,0,6756,653,6103
8454,5,0,0,0,0,0,48,5,43
8455,4,0,0,0,0,0,48,4,44
8474,2,0,0,0,0,0,24,2,22
8478,11,2,0,0,0,0,102,13,89
8479,344,51,75,15,2,1,3294,488,2806
8482,7,2,1,0,0,0,72,10,62
8483,16,1,1,1,0,0,114,19,95
8487,16,5,4,1,0,0,144,26,118
8488,13,2,2,0,0,0,102,17,85
8489,8,1,3,0,0,0,84,12,72
8491,9,2,2,0,0,0,102,13,89
8492,10,4,4,0,0,0,108,18,90
8493,14,2,6,0,0,0,138,22,116
0,0,0,0,0,0,0,0,0,0
0,0,0,0,0,0,0,0,0,0
0,0,0,0,0,0,0,0,0,0
8518,5,1,0,0,0,0,54,6,48
8525,12,2,1,0,0,0,132,15,117
8526,5,0,0,0,0,0,54,5,49
8527,10,2,2,1,0,0,138,15,123
8530,3,1,0,0,0,0,66,4,62
8537,11,5,2,0,0,0,108,18,90
8538,10,1,2,1,1,0,120,15,105
8543,7,1,0,0,0,0,60,8,52
8553,16,1,1,0,0,0,108,18,90
8557,2,0,0,0,1,1,36,4,32
8574,568,86,72,39,33,3,6390,801,5589
8583,4,0,0,0,0,0,30,4,26
8586,6,0,0,0,0,0,48,6,42
8587,8,1,0,1,0,0,66,10,56
8588,3,0,0,0,0,0,24,3,21
8589,4,0,0,0,0,0,42,4,38
8595,11,1,2,0,1,0,96,15,81
8597,8,0,0,0,0,0,90,8,82
0,0,0,0,0,0,0,0,0,0
0,0,0,0,0,0,0,0,0,0
0,0,0,0,0,0,0,0,0,0
0,0,0,0,0,0,0,0,0,0
0,0,0,0,0,0,0,0,0,0
8629,4,0,0,0,0,0,78,4,74
8630,7,2,1,1,0,0,84,11,73
8634,8,3,2,0,0,0,102,13,89
0,0,0,0,0,0,0,0,0,0
0,0,0,0,0,0,0,0,0,0
8648,119,23,14,3,4,1,1368,164,1204
8652,6,1,1,0,1,0,72,9,63
8655,16,3,2,0,0,0,138,21,117
8660,2,0,0,0,0,0,18,2,16
8664,393,34,43,16,0,5,3924,491,3433
8666,16,1,1,0,0,0,114,18,96
8667,7,0,0,0,0,0,72,7,65
8668,16,2,0,0,0,1,138,19,119
8673,18,2,1,0,0,0,132,21,111
8675,5,1,1,0,0,0,96,7,89
8693,6,0,1,0,0,0,66,7,59
8709,3,1,1,1,0,0,42,6,36
8711,13,2,0,0,0,0,138,15,123
8712,13,0,0,0,0,0,144,13,131
8713,4,0,0,0,0,0,36,4,32
0,0,0,0,0,0,0,0,0,0
8719,20,0,0,2,0,0,132,22,110
0,0,0,0,0,0,0,0,0,0
0,0,0,0,0,0,0,0,0,0
0,0,0,0,0,0,0,0,0,0
0,0,0,0,0,0,0,0,0,0
0,0,0,0,0,0,0,0,0,0
0,0,0,0,0,0,0,0,0,0
0,0,0,0,0,0,0,0,0,0
0,0,0,0,0,0,0,0,0,0
0,0,0,0,0,0,0,0,0,0
0,0,0,0,0,0,0,0,0,0
0,0,0,0,0,0,0,0,0,0
0,0,0,0,0,0,0,0,0,0
0,0,0,0,0,0,0,0,0,0
8793,12,0,1,0,0,0,90,13,77
8796,20,5,2,2,0,0,168,29,139
8799,280,44,36,8,3,6,2718,377,2341
8802,15,1,1,1,0,0,114,18,96
8806,4,2,2,1,0,0,54,9,45
8807,17,3,3,0,0,0,126,23,103
8825,5,2,0,0,0,0,72,7,65
8826,324,49,26,11,3,11,2976,424,2552
8830,13,5,1,2,0,0,114,21,93
8831,13,5,1,2,0,0,114,21,93
8834,10,0,0,0,0,0,78,10,68
8853,110,10,9,1,0,0,876,130,746
8881,20,4,3,1,0,0,168,28,140
8885,20,0,1,1,0,0,150,22,128
8886,12,1,1,0,0,0,96,14,82
8888,8,0,0,1,0,0,132,9,123
8889,282,68,30,4,6,5,3138,395,2743
8895,15,1,1,0,0,0,132,17,115
8898,10,0,0,2,0,0,90,12,78
8903,958,111,86,33,6,6,9558,1200,8358
8911,15,3,2,0,0,0,138,20,118
8915,10,3,3,0,1,0,108,17,91
8920,186,16,13,2,2,0,2040,219,1821
8924,9,0,1,0,0,0,78,10,68
8925,9,1,0,0,0,0,72,10,62
8934,222,14,16,6,2,1,1986,261,1725
8940,11,0,0,0,0,0,78,11,67
8941,11,0,0,0,0,0,78,11,67
8943,9,1,1,0,0,0,84,11,73
8944,2,0,0,0,0,0,42,2,40
8946,3,0,0,0,0,0,24,3,21
8947,14,0,1,0,0,0,126,15,111
8953,221,20,18,3,3,3,2064,268,1796
0,0,0,0,0,0,0,0,0,0
0,0,0,0,0,0,0,0,0,0
0,0,0,0,0,0,0,0,0,0
0,0,0,0,0,0,0,0,0,0
0,0,0,0,0,0,0,0,0,0
0,0,0,0,0,0,0,0,0,0
0,0,0,0,0,0,0,0,0,0
0,0,0,0,0,0,0,0,0,0
0,0,0,0,0,0,0,0,0,0
0,0,0,0,0,0,0,0,0,0
0,0,0,0,0,0,0,0,0,0
0,0,0,0,0,0,0,0,0,0
9063,8,1,1,0,0,1,90,11,79
9064,7,4,4,0,0,0,90,15,75
9071,5,0,0,0,0,0,84,5,79
9082,8,0,1,0,0,0,90,9,81
9083,5,0,0,1,0,0,78,6,72
9084,14,2,2,1,1,0,120,20,100
9115,9,3,1,1,0,0,90,14,76
9118,16,4,1,2,0,0,186,23,163
9119,8,1,1,0,0,0,78,10,68
9125,12,1,0,0,0,0,108,13,95
9127,19,4,1,0,0,0,168,24,144
9129,9,1,1,0,0,0,96,11,85
9131,10,3,2,0,0,0,72,15,57
9405,77,7,5,4,0,0,702,93,609
9410,12,1,1,1,0,0,102,15,87
9412,11,2,1,0,0,0,96,14,82
9413,5,0,2,1,0,1,72,9,63
0,0,0,0,0,0,0,0,0,0
9438,3,0,0,0,0,0,30,3,27
9439,8,3,0,0,0,0,102,11,91
9455,10,1,1,0,0,0,78,12,66
9456,10,1,1,0,0,0,78,12,66
9463,214,35,25,9,4,2,2280,289,1991
9475,2812,311,261,129,43,26,28026,3582,24444
9487,12,0,0,0,0,0,96,12,84
9501,12,2,0,1,0,0,114,15,99
9502,5,0,1,0,0,0,54,6,48
9503,8,1,0,0,0,0,66,9,57
9504,7,1,0,2,0,0,84,10,74
9512,2343,258,225,52,29,25,23328,2932,20396
9540,13,3,3,0,0,0,90,19,71
9541,9,2,1,0,1,1,90,14,76
9543,619,108,48,9,11,5,6372,800,5572
9559,5,1,0,0,0,0,60,6,54
9560,7,1,1,0,1,0,114,10,104
9567,8,2,2,0,1,0,84,13,71
9569,7,2,2,0,0,1,84,12,72
9570,9,1,2,0,0,0,108,12,96
9572,13,3,1,0,0,0,132,17,115
9573,13,3,0,0,0,0,126,16,110
9574,6,1,1,0,0,0,54,8,46
9586,432,54,35,14,5,2,4188,542,3646
9596,9,1,0,1,0,0,102,11,91
9598,12,3,2,0,1,0,126,18,108
9602,497,89,56,27,8,8,4956,685,4271
9627,8,1,1,0,0,1,96,11,85
9630,13,3,3,0,1,0,138,20,118
9632,17,2,2,2,0,0,138,23,115
9643,9,1,0,0,0,0,84,10,74
9649,7,1,0,0,0,1,66,9,57
0,0,0,0,0,0,0,0,0,0
0,0,0,0,0,0,0,0,0,0
0,0,0,0,0,0,0,0,0,0
0,0,0,0,0,0,0,0,0,0
0,0,0,0,0,0,0,0,0,0
0,0,0,0,0,0,0,0,0,0
0,0,0,0,0,0,0,0,0,0
9718,5,0,0,0,0,0,66,5,61
9723,8,2,1,0,0,0,102,11,91
9724,12,2,2,1,0,1,132,18,114
9732,17,1,0,0,0,0,138,18,120
9739,5,0,0,0,0,0,42,5,37
9741,215,23,16,6,2,1,2010,263,1747
9745,12,2,1,0,0,0,126,15,111
9746,18,1,0,0,1,0,144,20,124
9747,15,2,0,1,0,0,144,18,126
9748,8,3,3,0,0,1,84,15,69
9754,11,1,0,0,0,1,114,13,101
9755,17,1,2,0,0,0,156,20,136
9756,11,0,0,1,0,0,102,12,90
9854,6,0,0,0,0,0,60,6,54
9857,23,3,2,3,0,0,174,31,143
9858,23,3,2,3,0,0,174,31,143
9860,8,3,1,0,0,1,96,13,83
9861,3,1,0,0,0,0,48,4,44
9862,7,1,1,0,0,0,54,9,45
9863,8,1,2,0,0,0,96,11,85
9896,8,1,2,0,0,0,90,11,79
9897,8,1,2,0,0,0,90,11,79
9910,5,0,0,0,1,0,72,6,66
9914,5,1,2,0,0,0,48,8,40
9919,7,0,0,0,0,0,48,7,41
9923,15,6,2,1,0,0,138,24,114
9924,14,2,2,0,1,0,138,19,119
9925,12,1,0,0,0,0,132,13,119
9926,5,0,1,0,0,0,78,6,72
9927,6,0,0,0,0,0,78,6,72
9928,8,2,3,0,0,0,114,13,101
9930,248,46,26,2,3,0,3018,325,2693
0,0,0,0,0,0,0,0,0,0
9942,176,23,18,6,1,0,1542,224,1318
9952,13,0,0,0,0,0,96,13,83
9954,11,1,2,0,0,0,102,14,88
9957,12,3,1,0,0,0,96,16,80
9963,87,10,10,5,2,0,780,114,666
9973,4,0,0,0,0,0,48,4,44
9986,2265,260,196,73,16,17,21750,2827,18923
9996,10,1,1,0,1,0,96,13,83
9997,1,1,1,0,0,0,60,3,57
9998,19,0,1,0,0,0,174,20,154
9999,19,0,1,0,0,0,174,20,154
10000,16,2,1,1,0,0,126,20,106
10002,22,1,2,1,0,0,162,26,136
10005,14,2,1,0,1,0,114,18,96
10006,14,2,1,0,1,0,114,18,96
10012,11,2,3,0,0,0,96,16,80
10013,8,3,2,1,0,1,102,15,87
10017,4,0,0,0,0,0,66,4,62
10018,9,5,3,0,0,0,108,17,91
10038,8,3,2,1,0,1,102,15,87
10040,10,4,2,0,0,2,108,18,90
10041,9,1,1,0,0,0,60,11,49
10042,5,2,1,0,0,0,54,8,46
10043,11,1,2,0,0,0,114,14,100
10044,23,3,1,0,0,0,156,27,129
10045,8,0,1,0,0,0,84,9,75
10046,8,0,1,0,0,0,84,9,75
10059,10,0,1,0,0,0,96,11,85
10060,6,0,0,0,0,0,48,6,42
0,0,0,0,0,0,0,0,0,0
0,0,0,0,0,0,0,0,0,0
0,0,0,0,0,0,0,0,0,0
0,0,0,0,0,0,0,0,0,0
0,0,0,0,0,0,0,0,0,0
0,0,0,0,0,0,0,0,0,0
0,0,0,0,0,0,0,0,0,0
0,0,0,0,0,0,0,0,0,0
0,0,0,0,0,0,0,0,0,0
0,0,0,0,0,0,0,0,0,0
0,0,0,0,0,0,0,0,0,0
0,0,0,0,0,0,0,0,0,0
0,0,0,0,0,0,0,0,0,0
10141,17,2,2,1,0,0,162,22,140
10143,17,2,2,1,0,0,162,22,140
10144,7,1,1,0,0,0,54,9,45
10159,16,3,0,0,0,0,132,19,113
0,0,0,0,0,0,0,0,0,0
0,0,0,0,0,0,0,0,0,0
0,0,0,0,0,0,0,0,0,0
10170,16,4,2,0,0,0,138,22,116
10178,13,1,0,2,0,1,126,17,109
10179,8,0,1,0,0,0,60,9,51
10184,3,0,0,0,0,0,48,3,45
10185,5,0,0,0,0,0,54,5,49
10189,9,1,1,0,0,0,90,11,79
10190,8,0,1,0,0,0,90,9,81
10192,13,4,2,0,0,0,114,19,95
10195,7,0,0,0,0,0,54,7,47
10196,9,1,1,0,0,0,84,11,73
10210,8,1,1,0,0,0,60,10,50
10229,12,0,0,0,0,0,144,12,132
10231,23,0,1,0,1,0,162,25,137
10233,10,5,1,0,0,1,114,17,97
10235,8,0,1,2,0,0,108,11,97
10239,14,3,2,0,0,0,150,19,131
10240,7,2,0,0,0,0,114,9,105
0,0,0,0,0,0,0,0,0,0
0,0,0,0,0,0,0,0,0,0
0,0,0,0,0,0,0,0,0,0
10263,1,1,0,0,0,0,24,2,22
10264,12,1,0,1,0,0,96,14,82
10268,5,0,0,0,0,0,54,5,49
10269,11,2,0,1,0,0,120,14,106
10277,7,3,1,1,0,0,90,12,78
10278,62,2,2,0,0,0,654,66,588
10286,12,1,0,0,0,0,96,13,83
10287,8,1,0,0,0,0,90,9,81
10313,2074,258,180,80,21,42,20718,2655,18063
10326,4,0,0,1,1,0,42,6,36
0,0,0,0,0,0,0,0,0,0
10328,14,1,1,1,0,0,96,17,79
0,0,0,0,0,0,0,0,0,0
10330,5,1,3,0,0,0,90,9,81
10331,5,1,3,0,0,0,90,9,81
10347,91,14,7,3,5,4,984,124,860
10349,8,0,0,0,0,0,54,8,46
10358,18,2,3,0,0,0,144,23,121
10359,10,2,0,1,0,0,114,13,101
0,0,0,0,0,0,0,0,0,0
10371,12,2,1,0,3,0,144,18,126
10372,12,2,1,0,3,0,144,18,126
10373,9,3,1,0,1,0,126,14,112
10378,10,1,1,0,0,0,84,12,72
10379,12,0,0,3,0,0,108,15,93
10381,6,2,2,0,0,0,84,10,74
10382,7,2,1,0,0,1,60,11,49
10392,1441,183,124,63,28,38,16602,1877,14725
0,0,0,0,0,0,0,0,0,0
10422,10,2,1,0,0,0,102,13,89
10423,15,2,1,0,0,0,132,18,114
10424,14,1,1,0,0,0,120,16,104
10426,8,0,1,1,0,0,84,10,74
0,0,0,0,0,0,0,0,0,0
10441,18,1,0,0,0,0,156,19,137
10442,9,1,0,0,0,0,78,10,68
0,0,0,0,0,0,0,0,0,0
0,0,0,0,0,0,0,0,0,0
10485,12,1,0,0,0,0,90,13,77
10490,3,0,0,0,0,0,36,3,33
10491,8,0,0,0,0,0,84,8,76
10492,6,1,2,1,0,0,72,10,62
10493,1717,204,157,78,25,36,16668,2217,14451
10514,476,79,50,24,9,7,4938,645,4293
10517,5,1,0,0,0,0,60,6,54
10519,6,0,0,3,1,0,108,10,98
10520,5,0,0,1,0,0,60,6,54
10526,18,1,3,0,0,0,132,22,110
10527,18,1,3,0,0,0,132,22,110
10529,13,0,0,0,0,0,114,13,101
10534,5,0,0,0,0,0,42,5,37
10545,15,1,0,0,0,0,138,16,122
10548,8,1,0,0,0,0,114,9,105
10552,10,0,0,0,0,0,102,10,92
10553,13,1,0,0,0,1,96,15,81
10559,2,0,0,0,0,0,30,2,28
10578,6,2,3,0,0,0,72,11,61
10608,3,0,0,0,0,0,30,3,27
10609,17,1,0,0,0,0,120,18,102
10610,17,1,0,0,0,0,120,18,102
10611,7,1,1,0,0,0,48,9,39
10612,11,2,0,1,0,0,120,14,106
10613,20,2,1,1,0,0,162,24,138
10614,20,2,1,1,0,0,162,24,138
10619,8,0,0,0,0,0,60,8,52
10622,9,3,2,0,0,0,108,14,94
10625,7,0,0,0,0,1,66,8,58
10628,16,4,1,0,1,0,138,22,116
10629,10,2,4,0,0,0,84,16,68
10631,10,2,2,0,0,0,78,14,64
10632,11,3,4,0,0,0,96,18,78
10633,13,1,0,0,0,0,102,14,88
10635,7,2,1,0,0,1,72,11,61
10636,153,19,14,7,1,0,1380,194,1186
10638,4,1,0,0,0,0,54,5,49
10639,6,1,1,0,0,0,42,8,34
10640,11,0,0,0,0,0,72,11,61
0,0,0,0,0,0,0,0,0,0
0,0,0,0,0,0,0,0,0,0
0,0,0,0,0,0,0,0,0,0
0,0,0,0,0,0,0,0,0,0
0,0,0,0,0,0,0,0,0,0
0,0,0,0,0,0,0,0,0,0
0,0,0,0,0,0,0,0,0,0
0,0,0,0,0,0,0,0,0,0
0,0,0,0,0,0,0,0,0,0
10675,282,21,14,7,0,3,2538,327,2211
0,0,0,0,0,0,0,0,0,0
0,0,0,0,0,0,0,0,0,0
0,0,0,0,0,0,0,0,0,0
0,0,0,0,0,0,0,0,0,0
0,0,0,0,0,0,0,0,0,0
0,0,0,0,0,0,0,0,0,0
10838,12,2,0,2,0,0,138,16,122
10839,12,2,0,2,0,0,138,16,122
10840,9,2,1,1,0,0,102,13,89
0,0,0,0,0,0,0,0,0,0
10862,27,5,4,1,0,1,294,38,256
10867,7,2,2,1,0,0,78,12,66
10868,8,2,1,0,1,0,72,12,60
10869,5,3,0,0,0,0,54,8,46
10883,7,0,1,0,0,0,66,8,58
10884,8,1,0,0,0,0,78,9,69
10901,4,0,1,0,0,0,36,5,31
0,0,0,0,0,0,0,0,0,0
10915,6,0,0,0,0,0,60,6,54
0,0,0,0,0,0,0,0,0,0
0,0,0,0,0,0,0,0,0,0
0,0,0,0,0,0,0,0,0,0
0,0,0,0,0,0,0,0,0,0
0,0,0,0,0,0,0,0,0,0
0,0,0,0,0,0,0,0,0,0
10971,14,1,1,1,0,0,144,17,127
10978,8,1,0,0,0,0,90,9,81
10988,10,1,0,0,0,0,84,11,73
10990,8,0,0,0,0,0,60,8,52
10991,18,1,1,1,0,0,150,21,129
10992,11,6,3,0,0,0,132,20,112
10993,11,6,3,0,0,0,132,20,112
10994,11,2,0,0,0,0,114,13,101
0,0,0,0,0,0,0,0,0,0
11025,8,1,0,0,0,0,84,9,75
11048,16,1,1,0,0,0,114,18,96
11049,16,1,1,0,0,0,114,18,96
11054,15,1,1,1,0,0,108,18,90
11055,6,1,1,0,0,0,42,8,34
11057,271,39,23,7,0,2,2712,342,2370
11059,802,105,96,49,7,9,8280,1068,7212
11061,86,8,7,2,2,0,816,105,711
11065,22,0,1,0,0,0,168,23,145
11067,12,0,0,0,0,0,78,12,66
11069,16,2,3,1,0,0,138,22,116
11070,16,2,3,1,0,0,138,22,116
11071,19,1,1,0,0,0,132,21,111
11073,23,1,0,0,0,0,168,24,144
0,0,0,0,0,0,0,0,0,0
11108,6,2,1,0,0,0,48,9,39
11109,3,0,0,0,0,0,30,3,27
11110,3,2,1,0,0,0,30,6,24
11111,2,2,1,0,0,0,24,5,19
0,0,0,0,0,0,0,0,0,0
0,0,0,0,0,0,0,0,0,0
0,0,0,0,0,0,0,0,0,0
0,0,0,0,0,0,0,0,0,0
11130,5,0,0,0,0,0,42,5,37
11131,9,0,0,0,0,0,90,9,81
11132,18,1,1,0,0,0,120,20,100
11135,6,0,1,0,0,0,54,7,47
11173,12,1,0,1,0,0,90,14,76
11181,6,0,0,0,0,0,42,6,36
11192,16,1,1,0,0,0,120,18,102
11198,8,2,1,0,0,0,96,11,85
0,0,0,0,0,0,0,0,0,0
0,0,0,0,0,0,0,0,0,0
0,0,0,0,0,0,0,0,0,0
0,0,0,0,0,0,0,0,0,0
0,0,0,0,0,0,0,0,0,0
0,0,0,0,0,0,0,0,0,0
0,0,0,0,0,0,0,0,0,0
0,0,0,0,0,0,0,0,0,0
0,0,0,0,0,0,0,0,0,0
0,0,0,0,0,0,0,0,0,0
0,0,0,0,0,0,0,0,0,0
11259,68,7,7,1,0,4,792,87,705
0,0,0,0,0,0,0,0,0,0
0,0,0,0,0,0,0,0,0,0
0,0,0,0,0,0,0,0,0,0
0,0,0,0,0,0,0,0,0,0
0,0,0,0,0,0,0,0,0,0
11297,17,1,1,1,0,0,150,20,130
11299,10,0,0,0,0,0,78,10,68
11300,1,0,1,0,0,0,30,2,28
0,0,0,0,0,0,0,0,0,0
0,0,0,0,0,0,0,0,0,0
11318,1647,272,247,55,13,36,17250,2270,14980
11337,3,0,0,1,0,0,66,4,62
11338,11,4,1,0,0,0,114,16,98
11356,13,4,4,0,0,0,132,21,111
0,0,0,0,0,0,0,0,0,0
0,0,0,0,0,0,0,0,0,0
0,0,0,0,0,0,0,0,0,0
11376,5,0,0,0,0,0,42,5,37
11377,3,1,0,0,0,0,36,4,32
11378,5,0,0,0,0,0,30,5,25
11379,3,0,0,0,0,0,36,3,33
0,0,0,0,0,0,0,0,0,0
11408,7,1,2,0,0,0,72,10,62
11409,7,1,2,0,0,0,72,10,62
11410,13,2,3,0,0,0,114,18,96
11413,4,1,0,0,0,0,42,5,37
11414,155,28,9,2,2,0,1680,196,1484
0,0,0,0,0,0,0,0,0,0
0,0,0,0,0,0,0,0,0,0
11439,7,0,0,0,0,0,66,7,59
0,0,0,0,0,0,0,0,0,0
0,0,0,0,0,0,0,0,0,0
0,0,0,0,0,0,0,0,0,0
0,0,0,0,0,0,0,0,0,0
0,0,0,0,0,0,0,0,0,0
11487,8,2,1,0,0,0,66,11,55
0,0,0,0,0,0,0,0,0,0
11489,10,1,2,0,0,0,84,13,71
0,0,0,0,0,0,0,0,0,0
0,0,0,0,0,0,0,0,0,0
0,0,0,0,0,0,0,0,0,0
11502,171,27,9,19,1,2,1614,229,1385
0,0,0,0,0,0,0,0,0,0
0,0,0,0,0,0,0,0,0,0
0,0,0,0,0,0,0,0,0,0
11514,3,0,0,0,0,0,24,3,21
11515,5,2,1,0,0,0,48,8,40
11520,1,0,0,0,0,0,18,1,17
11527,5,0,0,0,0,0,66,5,61
11528,4,2,0,0,0,0,42,6,36
0,0,0,0,0,0,0,0,0,0
11545,196,48,25,3,2,1,2004,275,1729
0,0,0,0,0,0,0,0,0,0
0,0,0,0,0,0,0,0,0,0
11581,5,0,0,0,0,0,42,5,37
11606,16,5,0,0,0,0,138,21,117
0,0,0,0,0,0,0,0,0,0
0,0,0,0,0,0,0,0,0,0
0,0,0,0,0,0,0,0,0,0
0,0,0,0,0,0,0,0,0,0
0,0,0,0,0,0,0,0,0,0
11635,13,0,0,1,0,0,102,14,88
11646,212,39,23,7,3,7,2352,291,2061
11650,4,0,0,1,0,0,36,5,31
11651,10,1,1,0,0,0,96,12,84
11652,7,0,0,0,0,0,54,7,47
11661,7,1,1,0,0,0,84,9,75
11662,7,1,1,0,0,0,84,9,75
11664,3,1,1,0,0,1,54,6,48
0,0,0,0,0,0,0,0,0,0
0,0,0,0,0,0,0,0,0,0
0,0,0,0,0,0,0,0,0,0
0,0,0,0,0,0,0,0,0,0
11677,350,42,21,9,1,1,3132,424,2708
11683,7,1,1,0,0,0,60,9,51
11684,7,3,1,0,0,0,78,11,67
11685,17,3,2,0,0,0,150,22,128
11686,11,0,0,0,0,0,84,11,73
11687,10,2,0,0,0,0,84,12,72
11690,4,0,0,0,0,0,36,4,32
11691,6,0,0,1,0,1,78,8,70
11692,5,1,0,0,0,0,42,6,36
11693,6,1,1,0,0,0,60,8,52
0,0,0,0,0,0,0,0,0,0
12423,155,17,16,14,5,0,1494,207,1287
0,0,0,0,0,0,0,0,0,0
0,0,0,0,0,0,0,0,0,0
0,0,0,0,0,0,0,0,0,0
11734,8,1,2,2,0,1,96,14,82
11735,2,0,0,0,0,0,18,2,16
11736,10,3,1,0,0,0,90,14,76
11739,3,0,0,0,0,0,24,3,21
11776,6,1,2,0,0,0,54,9,45
11778,7,0,0,0,0,0,48,7,41
0,0,0,0,0,0,0,0,0,0
0,0,0,0,0,0,0,0,0,0
11796,6,1,2,1,0,0,66,10,56
11799,9,3,1,0,0,0,90,13,77
0,0,0,0,0,0,0,0,0,0
0,0,0,0,0,0,0,0,0,0
0,0,0,0,0,0,0,0,0,0
0,0,0,0,0,0,0,0,0,0
11828,5,0,1,0,0,0,60,6,54
11829,10,1,2,0,0,0,84,13,71
11830,4,0,0,1,0,0,42,5,37
11831,13,1,1,1,0,0,126,16,110
11834,7,3,0,0,0,0,78,10,68
11835,9,2,0,0,0,0,102,11,91
0,0,0,0,0,0,0,0,0,0
0,0,0,0,0,0,0,0,0,0
11851,17,2,1,1,0,0,138,21,117
11852,9,2,2,0,0,0,108,13,95
0,0,0,0,0,0,0,0,0,0
0,0,0,0,0,0,0,0,0,0
11871,12,3,3,0,1,1,108,20,88
11872,12,1,2,0,0,1,120,16,104
11876,7,2,2,0,0,0,78,11,67
11878,8,3,4,0,0,0,114,15,99
0,0,0,0,0,0,0,0,0,0
0,0,0,0,0,0,0,0,0,0
0,0,0,0,0,0,0,0,0,0
0,0,0,0,0,0,0,0,0,0
0,0,0,0,0,0,0,0,0,0
0,0,0,0,0,0,0,0,0,0
0,0,0,0,0,0,0,0,0,0
11911,1414,154,95,21,78,3,13674,1765,11909
11915,2384,274,191,71,36,18,22710,2974,19736
11919,9,1,0,0,0,0,72,10,62
11920,6,0,0,0,0,0,48,6,42
0,0,0,0,0,0,0,0,0,0
0,0,0,0,0,0,0,0,0,0
0,0,0,0,0,0,0,0,0,0
0,0,0,0,0,0,0,0,0,0
0,0,0,0,0,0,0,0,0,0
0,0,0,0,0,0,0,0,0,0
0,0,0,0,0,0,0,0,0,0
0,0,0,0,0,0,0,0,0,0
0,0,0,0,0,0,0,0,0,0
0,0,0,0,0,0,0,0,0,0
0,0,0,0,0,0,0,0,0,0
0,0,0,0,0,0,0,0,0,0
0,0,0,0,0,0,0,0,0,0
0,0,0,0,0,0,0,0,0,0
0,0,0,0,0,0,0,0,0,0
0,0,0,0,0,0,0,0,0,0
0,0,0,0,0,0,0,0,0,0
12051,163,17,12,5,1,0,1416,198,1218
12055,12,0,1,0,0,0,108,13,95
12056,8,1,2,1,0,0,84,12,72
12058,3,2,1,0,0,0,36,6,30
0,0,0,0,0,0,0,0,0,0
0,0,0,0,0,0,0,0,0,0
0,0,0,0,0,0,0,0,0,0
0,0,0,0,0,0,0,0,0,0
0,0,0,0,0,0,0,0,0,0
12077,8,0,0,1,0,0,54,9,45
0,0,0,0,0,0,0,0,0,0
12080,3,1,0,0,0,0,24,4,20
0,0,0,0,0,0,0,0,0,0
0,0,0,0,0,0,0,0,0,0
0,0,0,0,0,0,0,0,0,0
0,0,0,0,0,0,0,0,0,0
0,0,0,0,0,0,0,0,0,0
0,0,0,0,0,0,0,0,0,0
0,0,0,0,0,0,0,0,0,0
0,0,0,0,0,0,0,0,0,0
0,0,0,0,0,0,0,0,0,0
0,0,0,0,0,0,0,0,0,0
0,0,0,0,0,0,0,0,0,0
0,0,0,0,0,0,0,0,0,0
0,0,0,0,0,0,0,0,0,0
0,0,0,0,0,0,0,0,0,0
0,0,0,0,0,0,0,0,0,0
12130,11,1,1,0,0,0,90,13,77
12131,6,1,2,1,0,0,78,10,68
12133,5,1,0,1,0,0,54,7,47
12136,11,2,1,1,0,0,114,15,99
0,0,0,0,0,0,0,0,0,0
0,0,0,0,0,0,0,0,0,0
0,0,0,0,0,0,0,0,0,0
12147,232,34,21,9,1,3,2424,300,2124
12150,48,5,3,0,1,1,534,58,476
12154,11,2,2,2,0,0,96,17,79
12155,8,3,2,0,0,0,78,13,65
12157,21,2,1,0,0,0,156,24,132
12159,11,2,1,0,0,0,84,14,70
0,0,0,0,0,0,0,0,0,0
0,0,0,0,0,0,0,0,0,0
0,0,0,0,0,0,0,0,0,0
12226,43,3,5,0,0,0,408,51,357
0,0,0,0,0,0,0,0,0,0
0,0,0,0,0,0,0,0,0,0
0,0,0,0,0,0,0,0,0,0
0,0,0,0,0,0,0,0,0,0
0,0,0,0,0,0,0,0,0,0
12258,1734,245,148,99,46,25,17934,2297,15637
0,0,0,0,0,0,0,0,0,0
12265,9,0,0,0,0,0,78,9,69
12266,15,2,1,0,0,0,132,18,114
12268,8,0,0,0,0,0,60,8,52
0,0,0,0,0,0,0,0,0,0
12277,17,1,2,0,0,0,120,20,100
12279,11,1,1,0,0,0,90,13,77
12280,14,0,0,0,0,0,120,14,106
12281,9,0,0,0,0,0,72,9,63
0,0,0,0,0,0,0,0,0,0
0,0,0,0,0,0,0,0,0,0
0,0,0,0,0,0,0,0,0,0
12346,4,0,0,0,0,0,30,4,26
12347,11,0,0,0,0,0,84,11,73
12348,16,1,0,1,0,0,120,18,102
12353,7,2,1,0,0,0,66,10,56
12359,169,17,12,2,2,0,1416,202,1214
12361,8,0,0,0,0,0,60,8,52
12362,7,2,1,0,0,0,96,10,86
12363,18,3,2,2,0,0,150,25,125
12365,12,1,0,0,0,0,108,13,95
12366,15,1,1,0,0,0,126,17,109
12367,7,1,1,1,0,0,66,10,56
0,0,0,0,0,0,0,0,0,0
0,0,0,0,0,0,0,0,0,0
0,0,0,0,0,0,0,0,0,0
12404,109,8,7,3,3,0,1200,130,1070
12406,8,3,0,1,0,1,120,13,107
0,0,0,0,0,0,0,0,0,0
0,0,0,0,0,0,0,0,0,0
12429,5,1,0,0,0,0,84,6,78
12430,4,0,0,0,0,0,36,4,32
12431,2,0,0,0,0,0,24,2,22
12439,8,0,0,1,1,0,72,10,62
12440,14,1,1,0,0,0,114,16,98
12442,14,2,1,0,0,0,150,17,133
0,0,0,0,0,0,0,0,0,0
0,0,0,0,0,0,0,0,0,0
12464,18,4,2,0,0,1,150,25,125
12465,9,2,1,1,0,0,90,13,77
12470,7,3,1,1,0,0,102,12,90
12471,10,3,2,0,0,0,102,15,87
0,0,0,0,0,0,0,0,0,0
0,0,0,0,0,0,0,0,0,0
0,0,0,0,0,0,0,0,0,0
0,0,0,0,0,0,0,0,0,0
12932,200,21,22,3,0,0,1752,246,1506
12489,177,16,22,8,1,2,1758,226,1532
0,0,0,0,0,0,0,0,0,0
0,0,0,0,0,0,0,0,0,0
0,0,0,0,0,0,0,0,0,0
0,0,0,0,0,0,0,0,0,0
12502,11,1,1,1,0,0,96,14,82
12503,8,1,1,0,0,0,66,10,56
12506,9,0,0,0,0,0,78,9,69
12507,14,3,3,1,0,0,114,21,93
12508,12,2,2,1,0,0,114,17,97
12548,368,16,14,28,7,2,3504,435,3069
0,0,0,0,0,0,0,0,0,0
12554,15,1,1,0,0,0,126,17,109
12555,15,1,1,0,0,0,126,17,109
0,0,0,0,0,0,0,0,0,0
0,0,0,0,0,0,0,0,0,0
12566,98,7,7,3,0,1,1206,116,1090
0,0,0,0,0,0,0,0,0,0
0,0,0,0,0,0,0,0,0,0
0,0,0,0,0,0,0,0,0,0
12581,7,1,1,0,0,1,84,10,74
12582,8,1,1,0,0,0,60,10,50
12583,4,2,1,0,0,0,48,7,41
12584,6,1,0,0,0,0,48,7,41
12585,12,2,1,0,0,0,96,15,81
12629,11,0,1,0,2,0,108,14,94
12630,9,2,2,1,0,0,114,14,100
12632,19,2,1,1,0,0,156,23,133
0,0,0,0,0,0,0,0,0,0
0,0,0,0,0,0,0,0,0,0
0,0,0,0,0,0,0,0,0,0
0,0,0,0,0,0,0,0,0,0
12651,1868,180,175,65,69,17,18030,2374,15656
12663,179,16,10,3,0,2,1524,210,1314
12678,4,0,0,0,0,0,36,4,32
0,0,0,0,0,0,0,0,0,0
12685,12,3,2,0,0,0,120,17,103
12687,6,3,1,0,0,0,60,10,50
12688,12,0,0,0,0,1,120,13,107
12689,18,2,1,1,1,1,174,24,150
12690,18,2,1,1,1,1,174,24,150
0,0,0,0,0,0,0,0,0,0
0,0,0,0,0,0,0,0,0,0
0,0,0,0,0,0,0,0,0,0
12703,298,15,20,1,0,0,2598,334,2264
0,0,0,0,0,0,0,0,0,0
0,0,0,0,0,0,0,0,0,0
0,0,0,0,0,0,0,0,0,0
0,0,0,0,0,0,0,0,0,0
0,0,0,0,0,0,0,0,0,0
0,0,0,0,0,0,0,0,0,0
0,0,0,0,0,0,0,0,0,0
12733,5,0,0,0,0,0,36,5,31
12751,7,4,0,0,0,0,120,11,109
12752,7,4,0,0,0,0,120,11,109
12753,12,2,0,0,0,0,108,14,94
12754,16,2,2,0,0,0,156,20,136
12756,15,3,3,0,0,0,126,21,105
12758,21,4,0,0,0,0,162,25,137
12759,11,2,2,0,0,0,120,15,105
12760,12,1,0,0,0,0,114,13,101
12762,10,0,0,0,0,0,90,10,80
12763,4,1,1,0,0,0,60,6,54
12768,6,0,0,1,0,0,66,7,59
0,0,0,0,0,0,0,0,0,0
12780,1634,186,158,37,14,9,15888,2038,13850
12805,10,2,0,1,1,3,132,17,115
12808,13,0,2,0,0,0,102,15,87
0,0,0,0,0,0,0,0,0,0
0,0,0,0,0,0,0,0,0,0
12857,11,1,1,0,1,1,114,15,99
12860,4,0,1,0,0,0,36,5,31
0,0,0,0,0,0,0,0,0,0
0,0,0,0,0,0,0,0,0,0
0,0,0,0,0,0,0,0,0,0
12872,13,4,1,1,0,0,126,19,107
12873,13,4,1,1,0,0,126,19,107
12876,17,3,3,0,0,0,156,23,133
0,0,0,0,0,0,0,0,0,0
12890,1791,172,119,52,38,21,16776,2193,14583
12914,14,2,2,1,0,0,126,19,107
12915,14,2,1,2,0,0,144,19,125
0,0,0,0,0,0,0,0,0,0
0,0,0,0,0,0,0,0,0,0
0,0,0,0,0,0,0,0,0,0
12928,4,1,1,0,0,0,66,6,60
12934,319,46,36,8,4,5,3108,418,2690
12936,8,0,0,0,0,0,78,8,70
12938,6,0,0,0,0,0,42,6,36
12940,5,0,0,0,0,0,54,5,49
0,0,0,0,0,0,0,0,0,0
12958,642,60,33,48,3,5,6558,791,5767
0,0,0,0,0,0,0,0,0,0
0,0,0,0,0,0,0,0,0,0
12966,5,1,0,0,0,0,48,6,42
0,0,0,0,0,0,0,0,0,0
12971,1648,224,209,45,14,33,15402,2173,13229
12990,11,0,0,0,0,0,78,11,67
12991,7,0,0,0,0,0,54,7,47
12993,10,2,2,1,0,1,108,16,92
0,0,0,0,0,0,0,0,0,0
0,0,0,0,0,0,0,0,0,0
13006,3,0,1,0,0,0,42,4,38
0,0,0,0,0,0,0,0,0,0
0,0,0,0,0,0,0,0,0,0
13023,4,0,0,0,0,0,42,4,38
0,0,0,0,0,0,0,0,0,0
0,0,0,0,0,0,0,0,0,0
13030,10,0,1,2,0,0,162,13,149
13033,11,2,1,1,0,0,96,15,81
13034,14,0,1,1,0,1,144,17,127
13035,14,0,0,0,0,0,108,14,94
13036,65,11,1,10,1,0,672,88,584
0,0,0,0,0,0,0,0,0,0
13078,10,2,1,2,0,0,120,15,105
13079,14,1,1,1,0,0,120,17,103
13082,8,1,0,0,0,0,102,9,93
13083,11,2,1,0,0,0,114,14,100
13085,14,0,0,0,0,0,126,14,112
0,0,0,0,0,0,0,0,0,0
13098,211,30,17,15,4,2,2472,279,2193
0,0,0,0,0,0,0,0,0,0
0,0,0,0,0,0,0,0,0,0
0,0,0,0,0,0,0,0,0,0
13132,1690,194,138,30,25,11,15906,2088,13818
13139,13,2,2,0,1,0,108,18,90
13140,9,1,0,0,0,0,72,10,62
13146,16,2,1,0,0,0,138,19,119
13148,13,3,3,0,0,1,138,20,118
13151,65,11,6,0,0,0,612,82,530
13155,2,0,0,0,0,0,24,2,22
0,0,0,0,0,0,0,0,0,0
0,0,0,0,0,0,0,0,0,0
13162,18,2,1,0,0,0,138,21,117
13165,7,0,0,1,0,0,66,8,58
0,0,0,0,0,0,0,0,0,0
0,0,0,0,0,0,0,0,0,0
0,0,0,0,0,0,0,0,0,0
0,0,0,0,0,0,0,0,0,0
13215,9,3,3,0,0,0,120,15,105
13216,8,2,1,0,0,0,108,11,97
13217,4,0,0,0,0,0,48,4,44
13218,11,3,2,0,0,0,114,16,98
13227,4,0,1,0,0,0,72,5,67
13243,13,2,2,0,0,0,96,17,79
13251,6,0,0,0,0,0,66,6,60
13252,6,0,0,0,0,0,66,6,60
13255,3,0,0,0,0,0,36,3,33
13260,14,1,2,1,0,0,114,18,96
0,0,0,0,0,0,0,0,0,0
0,0,0,0,0,0,0,0,0,0
0,0,0,0,0,0,0,0,0,0
13274,15,2,0,0,0,0,120,17,103
13275,6,0,0,0,1,1,66,8,58
13276,7,0,0,1,1,0,72,9,63
13278,5,0,0,1,0,0,72,6,66
13279,9,0,1,0,0,0,102,10,92
13280,9,1,2,0,0,0,96,12,84
13281,11,1,2,0,0,0,102,14,88
0,0,0,0,0,0,0,0,0,0
13288,54,3,4,0,0,0,558,61,497
0,0,0,0,0,0,0,0,0,0
0,0,0,0,0,0,0,0,0,0
13339,17,2,1,0,0,0,156,20,136
13340,10,0,0,0,0,0,66,10,56
13341,21,0,0,0,0,0,156,21,135
13359,11,3,2,0,1,0,114,17,97
0,0,0,0,0,0,0,0,0,0
13364,15,0,0,0,0,0,114,15,99
13365,11,2,2,0,0,0,138,15,123
13367,109,10,4,1,2,1,1140,127,1013
13372,11,0,0,0,0,0,114,11,103
13373,11,0,0,0,0,0,114,11,103
13374,3,0,0,0,0,0,48,3,45
13375,6,0,0,0,0,0,54,6,48
13376,9,3,1,0,0,0,90,13,77
13377,8,1,1,1,0,0,72,11,61
0,0,0,0,0,0,0,0,0,0
0,0,0,0,0,0,0,0,0,0
13398,11,0,0,0,0,1,90,12,78
13402,6,0,0,0,0,0,60,6,54
13408,7,0,1,0,0,0,84,8,76
0,0,0,0,0,0,0,0,0,0
13414,6,0,0,1,0,0,72,7,65
13415,12,3,2,1,0,0,108,18,90
13416,11,0,0,0,0,0,90,11,79
13417,4,1,1,0,0,0,36,6,30
0,0,0,0,0,0,0,0,0,0
13441,9,2,0,1,0,0,102,12,90
13445,8,4,1,0,0,1,120,14,106
13446,5,1,0,0,0,0,60,6,54
13447,7,3,1,0,0,0,78,11,67
13478,3,2,0,0,0,0,36,5,31
13479,6,0,0,0,0,0,48,6,42
13480,4,0,0,0,0,0,36,4,32
0,0,0,0,0,0,0,0,0,0
0,0,0,0,0,0,0,0,0,0
13489,6,2,1,0,0,0,48,9,39
13490,12,1,2,1,0,0,102,16,86
13491,2,1,0,0,0,0,36,3,33
13493,11,2,2,0,0,0,72,15,57
13494,2,1,0,0,0,0,30,3,27
13496,3,1,0,0,0,0,36,4,32
0,0,0,0,0,0,0,0,0,0
0,0,0,0,0,0,0,0,0,0
0,0,0,0,0,0,0,0,0,0
13515,189,12,7,3,0,0,1758,211,1547
13521,7,0,0,0,0,0,78,7,71
13522,11,0,0,0,0,0,108,11,97
0,0,0,0,0,0,0,0,0,0
0,0,0,0,0,0,0,0,0,0
0,0,0,0,0,0,0,0,0,0
13538,13,0,0,0,0,0,96,13,83
13539,11,1,1,0,0,0,78,13,65
13540,22,1,0,0,0,0,156,23,133
13542,13,0,0,0,0,0,90,13,77
13543,13,0,0,0,0,0,90,13,77
0,0,0,0,0,0,0,0,0,0
13546,167,25,23,2,2,0,1614,219,1395
0,0,0,0,0,0,0,0,0,0
13578,5,0,0,0,0,0,60,5,55
13580,7,1,1,0,0,0,60,9,51
13588,3,1,0,0,0,0,54,4,50
13591,7,0,1,0,0,0,54,8,46
0,0,0,0,0,0,0,0,0,0
0,0,0,0,0,0,0,0,0,0
0,0,0,0,0,0,0,0,0,0
0,0,0,0,0,0,0,0,0,0
13640,7,0,1,0,0,0,72,8,64
13642,21,2,0,0,0,0,168,23,145
13643,7,1,3,0,0,1,84,12,72
13644,7,0,0,0,0,0,78,7,71
0,0,0,0,0,0,0,0,0,0
13655,6,1,0,0,0,0,72,7,65
13656,16,3,2,0,0,0,138,21,117
13658,11,4,1,0,0,0,96,16,80
13659,13,3,1,0,0,1,144,18,126
13660,217,20,13,0,4,1,2052,255,1797
13681,12,0,1,0,0,0,108,13,95
13684,5,0,0,0,0,0,54,5,49
0,0,0,0,0,0,0,0,0,0
0,0,0,0,0,0,0,0,0,0
13691,5,2,1,0,0,0,72,8,64
13695,20,3,2,0,0,0,156,25,131
13698,14,1,0,0,0,0,114,15,99
0,0,0,0,0,0,0,0,0,0
0,0,0,0,0,0,0,0,0,0
0,0,0,0,0,0,0,0,0,0
0,0,0,0,0,0,0,0,0,0
13718,10,1,1,0,0,0,90,12,78
13719,14,0,0,0,0,0,120,14,106
13733,9,1,1,0,0,0,72,11,61
13738,578,50,41,8,2,12,5328,691,4637
13765,23,1,1,0,0,0,150,25,125
13766,10,0,0,0,0,0,90,10,80
13770,4,1,1,0,0,0,42,6,36
0,0,0,0,0,0,0,0,0,0
13789,1289,147,95,59,10,10,11826,1610,10216
0,0,0,0,0,0,0,0,0,0
0,0,0,0,0,0,0,0,0,0
13806,3,1,0,0,0,0,48,4,44
13807,9,3,0,0,0,0,96,12,84
0,0,0,0,0,0,0,0,0,0
0,0,0,0,0,0,0,0,0,0
13830,4,1,0,0,0,0,48,5,43
13831,9,0,0,1,0,1,114,11,103
13832,11,2,0,0,0,0,102,13,89
13833,10,0,0,0,0,0,108,10,98
13834,7,0,0,0,0,0,66,7,59
13836,12,0,0,0,0,0,108,12,96
13838,13,4,3,0,0,0,96,20,76
13839,18,1,0,0,0,1,162,20,142
13842,207,22,16,9,0,0,1932,254,1678
0,0,0,0,0,0,0,0,0,0
0,0,0,0,0,0,0,0,0,0
13874,13,3,1,0,0,0,114,17,97
13875,13,3,1,0,0,0,114,17,97
0,0,0,0,0,0,0,0,0,0
0,0,0,0,0,0,0,0,0,0
13888,1,0,0,0,0,0,18,1,17
13889,6,0,0,0,0,0,60,6,54
13890,3,0,2,0,0,0,48,5,43
13912,5,1,1,0,0,0,66,7,59
13913,8,0,1,0,0,0,84,9,75
0,0,0,0,0,0,0,0,0,0
0,0,0,0,0,0,0,0,0,0
13923,156,18,11,1,2,0,1410,188,1222
13925,21,1,0,2,0,0,186,24,162
13927,9,2,2,0,0,0,84,13,71
13928,14,2,0,0,0,0,114,16,98
0,0,0,0,0,0,0,0,0,0
13944,274,42,27,3,4,1,2514,351,2163
13946,12,0,0,0,1,1,102,14,88
13947,12,0,0,0,1,1,102,14,88
13954,16,4,2,1,0,0,162,23,139
13956,13,1,1,0,0,0,96,15,81
13957,6,1,0,0,0,0,72,7,65
0,0,0,0,0,0,0,0,0,0
13965,7,2,0,0,0,0,78,9,69
13968,8,0,0,0,0,0,60,8,52
13969,11,1,1,0,0,0,108,13,95
0,0,0,0,0,0,0,0,0,0
0,0,0,0,0,0,0,0,0,0
13975,15,3,1,0,0,0,138,19,119
13977,12,3,1,0,0,0,108,16,92
13979,12,2,2,2,0,0,126,18,108
13980,18,1,0,0,0,0,126,19,107
14007,1011,119,84,38,13,12,9456,1277,8179
14013,695,116,57,19,2,6,6882,895,5987
0,0,0,0,0,0,0,0,0,0
0,0,0,0,0,0,0,0,0,0
14023,4,0,0,0,0,0,30,4,26
14038,257,25,16,10,4,3,2412,315,2097
14040,7,0,1,0,1,0,84,9,75
14042,14,5,2,1,0,0,162,22,140
0,0,0,0,0,0,0,0,0,0
0,0,0,0,0,0,0,0,0,0
0,0,0,0,0,0,0,0,0,0
14054,9,4,1,0,0,0,102,14,88
14056,8,1,1,1,0,0,60,11,49
14067,10,3,2,0,0,0,90,15,75
0,0,0,0,0,0,0,0,0,0
14075,8,2,1,0,0,0,90,11,79
14076,8,2,1,0,0,0,90,11,79
14077,12,1,1,0,0,0,120,14,106
14078,8,1,1,0,0,0,84,10,74
14081,8,0,0,0,0,0,126,8,118
14082,266,12,21,7,3,2,2592,311,2281
0,0,0,0,0,0,0,0,0,0
0,0,0,0,0,0,0,0,0,0
14092,280,18,13,3,1,3,2484,318,2166
14112,14,1,1,0,0,0,114,16,98
14113,18,2,1,1,0,0,138,22,116
14117,8,2,0,0,0,0,96,10,86
0,0,0,0,0,0,0,0,0,0
0,0,0,0,0,0,0,0,0,0
14129,3,1,0,0,0,0,36,4,32
14147,4,5,0,0,0,0,66,9,57
14149,8,3,1,0,0,0,78,12,66
14151,9,1,0,0,0,1,72,11,61
14153,9,1,0,0,0,0,78,10,68
14154,3,1,0,0,0,0,42,4,38
0,0,0,0,0,0,0,0,0,0
14172,75,13,5,1,0,0,792,94,698
0,0,0,0,0,0,0,0,0,0
14182,9,0,0,0,0,1,78,10,68
14184,22,0,0,1,0,0,168,23,145
0,0,0,0,0,0,0,0,0,0
14186,22,0,0,1,0,0,168,23,145
14197,7,0,2,0,0,0,66,9,57
14198,6,0,0,0,0,0,54,6,48
0,0,0,0,0,0,0,0,0,0
0,0,0,0,0,0,0,0,0,0
0,0,0,0,0,0,0,0,0,0
14234,7,0,0,0,0,0,78,7,71
14236,20,3,2,0,0,0,150,25,125
14238,6,1,1,1,0,0,66,9,57
14239,6,1,1,1,0,0,66,9,57
0,0,0,0,0,0,0,0,0,0
0,0,0,0,0,0,0,0,0,0
14254,10,3,3,0,0,0,126,16,110
14255,4,1,2,0,0,0,60,7,53
14256,8,2,2,0,0,0,102,12,90
0,0,0,0,0,0,0,0,0,0
14260,98,8,5,1,0,3,1074,115,959
0,0,0,0,0,0,0,0,0,0
0,0,0,0,0,0,0,0,0,0
14268,3,1,1,0,0,0,36,5,31
0,0,0,0,0,0,0,0,0,0
0,0,0,0,0,0,0,0,0,0
14296,11,3,4,0,0,0,90,18,72
14297,165,11,15,1,0,0,1854,192,1662
14299,3,0,1,0,0,0,30,4,26
14301,1,0,0,0,0,0,12,1,11
0,0,0,0,0,0,0,0,0,0
0,0,0,0,0,0,0,0,0,0
14314,11,0,0,2,0,0,96,13,83
14318,17,2,1,1,0,0,132,21,111
14319,9,1,1,0,0,0,90,11,79
14320,5,0,1,1,0,0,72,7,65
14341,13,1,1,0,0,0,108,15,93
14342,7,2,1,0,0,0,72,10,62
0,0,0,0,0,0,0,0,0,0
0,0,0,0,0,0,0,0,0,0
0,0,0,0,0,0,0,0,0,0
14350,19,2,2,0,0,0,132,23,109
14353,12,2,3,0,1,0,138,18,120
14354,9,1,2,0,0,0,78,12,66
14355,11,1,1,4,0,0,120,17,103
14359,225,27,21,2,5,1,2328,281,2047
0,0,0,0,0,0,0,0,0,0
0,0,0,0,0,0,0,0,0,0
0,0,0,0,0,0,0,0,0,0
14371,16,3,3,0,0,0,138,22,116
14374,5,0,2,0,0,0,66,7,59
14381,8,2,2,0,0,0,90,12,78
0,0,0,0,0,0,0,0,0,0
14402,5,0,0,0,0,0,36,5,31
14403,6,0,0,0,0,0,78,6,72
0,0,0,0,0,0,0,0,0,0
0,0,0,0,0,0,0,0,0,0
14408,328,50,40,11,0,0,2970,429,2541
0,0,0,0,0,0,0,0,0,0
14418,11,0,0,0,0,0,102,11,91
14419,9,3,0,1,0,0,96,13,83
14420,7,2,0,0,0,0,66,9,57
14421,15,3,2,0,0,0,114,20,94
14422,14,3,3,0,0,0,90,20,70
14423,5,0,0,0,0,0,42,5,37
14426,213,16,12,0,1,1,2052,243,1809
0,0,0,0,0,0,0,0,0,0
0,0,0,0,0,0,0,0,0,0
14477,12,1,3,0,1,0,114,17,97
0,0,0,0,0,0,0,0,0,0
0,0,0,0,0,0,0,0,0,0
0,0,0,0,0,0,0,0,0,0
14488,6,0,0,0,0,0,48,6,42
14492,11,1,2,0,0,0,84,14,70
0,0,0,0,0,0,0,0,0,0
0,0,0,0,0,0,0,0,0,0
0,0,0,0,0,0,0,0,0,0
0,0,0,0,0,0,0,0,0,0
0,0,0,0,0,0,0,0,0,0
14568,12,1,2,0,2,0,114,17,97
14569,9,1,2,0,1,0,78,13,65
14570,17,0,0,0,0,0,120,17,103
14571,4,0,1,0,0,0,48,5,43
14573,11,1,1,0,0,0,108,13,95
14575,5,1,1,0,0,0,42,7,35
14576,24,2,2,0,1,0,192,29,163
14577,19,3,4,0,0,0,150,26,124
14589,12,1,1,0,0,0,108,14,94
14590,4,0,0,1,0,0,54,5,49
14591,15,6,5,0,0,1,126,27,99
14597,75,10,14,2,0,0,900,101,799
14603,3,0,0,0,0,0,30,3,27
14605,6,0,0,0,1,0,54,7,47
14623,1390,189,133,93,16,34,13992,1855,12137
0,0,0,0,0,0,0,0,0,0
0,0,0,0,0,0,0,0,0,0
14675,261,24,14,1,4,7,2328,311,2017
14677,10,0,0,0,0,0,78,10,68
14678,4,0,0,0,0,0,36,4,32
14680,4,0,0,0,1,0,54,5,49
14684,9,4,0,0,0,0,84,13,71
0,0,0,0,0,0,0,0,0,0
0,0,0,0,0,0,0,0,0,0
0,0,0,0,0,0,0,0,0,0
14716,15,4,5,1,0,1,162,26,136
14718,13,2,2,0,0,0,108,17,91
0,0,0,0,0,0,0,0,0,0
14729,186,18,17,6,1,4,2004,232,1772
0,0,0,0,0,0,0,0,0,0
14739,18,3,6,1,0,1,168,29,139
14744,111,16,9,1,3,0,1278,140,1138
14749,19,3,1,0,1,0,180,24,156
0,0,0,0,0,0,0,0,0,0
14760,14,1,1,0,0,0,96,16,80
14761,10,2,2,0,0,0,114,14,100
14762,11,0,0,0,0,0,84,11,73
14763,10,0,0,0,0,0,96,10,86
0,0,0,0,0,0,0,0,0,0
14789,7,0,0,0,0,0,54,7,47
14790,10,0,0,0,0,0,96,10,86
0,0,0,0,0,0,0,0,0,0
14795,6,0,0,0,0,0,60,6,54
14796,8,0,0,0,0,0,60,8,52
0,0,0,0,0,0,0,0,0,0
14801,6,3,0,0,0,0,90,9,81
0,0,0,0,0,0,0,0,0,0
14804,7,3,2,1,0,1,108,14,94
14811,11,1,1,0,0,0,120,13,107
14814,17,4,1,0,1,0,162,23,139
14815,20,1,1,0,0,0,156,22,134
14818,5,1,1,0,0,0,48,7,41
0,0,0,0,0,0,0,0,0,0
0,0,0,0,0,0,0,0,0,0
14842,273,13,7,7,14,0,2634,314,2320
14844,7,1,1,0,0,0,60,9,51
14845,4,0,0,0,0,0,36,4,32
0,0,0,0,0,0,0,0,0,0
0,0,0,0,0,0,0,0,0,0
14859,68,5,2,1,0,0,816,76,740
0,0,0,0,0,0,0,0,0,0
14865,9,1,2,0,0,0,84,12,72
0,0,0,0,0,0,0,0,0,0
14869,11,1,1,0,0,0,90,13,77
14870,7,3,1,0,0,0,66,11,55
14871,5,0,0,0,0,0,42,5,37
14872,14,2,2,2,0,0,108,20,88
14880,5,0,0,0,0,1,48,6,42
14889,1864,271,191,81,22,41,18432,2470,15962
0,0,0,0,0,0,0,0,0,0
14898,342,46,25,9,6,5,3204,433,2771
0,0,0,0,0,0,0,0,0,0
14909,10,1,0,0,0,1,108,12,96
14913,15,0,1,0,0,0,132,16,116
0,0,0,0,0,0,0,0,0,0
14931,8,1,0,0,0,0,78,9,69
14932,3,1,1,0,0,0,36,5,31
14934,10,1,0,1,0,0,90,12,78
14935,6,1,0,1,0,0,66,8,58
14937,9,1,0,0,0,0,78,10,68
0,0,0,0,0,0,0,0,0,0
14953,6,1,3,0,0,0,72,10,62
14954,17,5,4,1,0,0,156,27,129
14955,17,5,4,1,0,0,156,27,129
0,0,0,0,0,0,0,0,0,0
14960,175,29,16,5,2,4,1830,231,1599
0,0,0,0,0,0,0,0,0,0
14966,8,5,2,0,0,0,84,15,69
0,0,0,0,0,0,0,0,0,0
0,0,0,0,0,0,0,0,0,0
0,0,0,0,0,0,0,0,0,0
14981,2,0,0,0,0,0,24,2,22
14982,8,0,0,0,0,0,60,8,52
14983,7,0,2,0,1,0,60,10,50
0,0,0,0,0,0,0,0,0,0
0,0,0,0,0,0,0,0,0,0
0,0,0,0,0,0,0,0,0,0
15006,10,1,0,0,0,0,96,11,85
15010,6,2,1,0,0,0,54,9,45
15014,14,1,0,0,0,0,120,15,105
15037,12,1,2,0,0,0,102,15,87
15038,4,0,0,0,0,0,30,4,26
15044,11,1,1,0,0,0,90,13,77
15045,11,2,3,0,0,0,102,16,86
0,0,0,0,0,0,0,0,0,0
15053,271,27,14,2,4,0,2814,318,2496
0,0,0,0,0,0,0,0,0,0
0,0,0,0,0,0,0,0,0,0
0,0,0,0,0,0,0,0,0,0
15086,4,0,1,0,0,0,60,5,55
15093,16,4,1,0,0,0,150,21,129
15094,10,2,5,1,1,0,144,19,125
15095,10,1,0,0,0,0,78,11,67
15100,1764,162,104,56,3,12,16044,2101,13943
0,0,0,0,0,0,0,0,0,0
0,0,0,0,0,0,0,0,0,0
15121,89,10,5,4,0,0,876,108,768
0,0,0,0,0,0,0,0,0,0
0,0,0,0,0,0,0,0,0,0
15131,15,1,2,0,0,0,192,18,174
15132,15,1,2,0,0,0,192,18,174
15133,5,1,0,1,0,0,54,7,47
15134,10,1,0,1,0,0,132,12,120
15136,15,0,0,0,1,0,120,16,104
0,0,0,0,0,0,0,0,0,0
0,0,0,0,0,0,0,0,0,0
0,0,0,0,0,0,0,0,0,0
15153,6,0,1,0,0,0,54,7,47
15157,8,1,0,0,0,0,72,9,63
15158,130,20,12,4,0,1,1710,167,1543
0,0,0,0,0,0,0,0,0,0
0,0,0,0,0,0,0,0,0,0
15168,3,0,0,0,0,0,30,3,27
0,0,0,0,0,0,0,0,0,0
15173,16,4,2,0,0,0,162,22,140
15174,17,2,3,1,0,0,156,23,133
0,0,0,0,0,0,0,0,0,0
15187,8,0,0,0,1,0,108,9,99
0,0,0,0,0,0,0,0,0,0
15199,241,39,22,4,0,2,2382,308,2074
15220,16,0,0,0,0,0,120,16,104
15222,5,0,0,0,0,0,48,5,43
15225,16,0,2,0,0,0,132,18,114
15226,16,1,1,0,2,0,174,20,154
