postId,a1,a2,b1,b2,c1,c2,processed,found,missed
4947,8,8,8,6,3,0,78,33,45
8215,17,18,10,10,5,6,156,66,90
0,0,0,0,0,0,0,0,0,0
11797,8,6,4,2,0,0,78,20,58
0,0,0,0,0,0,0,0,0,0
431,192,150,101,71,41,22,1986,577,1409
440,168,159,91,70,64,28,2124,580,1544
21,663,506,389,286,172,87,6714,2103,4611
27,454,383,268,203,147,68,5328,1523,3805
30,340,271,221,151,117,35,3708,1135,2573
35,72,60,43,35,26,15,1074,251,823
37,114,109,102,77,70,24,1842,496,1346
3548,242,214,144,96,72,44,2928,812,2116
39,454,426,299,242,145,100,5004,1666,3338
42,601,502,359,228,131,80,5928,1901,4027
44,210,198,135,72,61,44,2940,720,2220
48,197,175,120,84,51,34,2370,661,1709
52,271,250,187,118,84,38,3306,948,2358
3647,163,132,91,65,36,24,2316,511,1805
250,173,135,95,58,33,22,2070,516,1554
59,404,333,237,197,113,67,4860,1351,3509
5103,56,38,46,20,21,11,738,192,546
3591,176,148,112,93,65,35,2322,629,1693
63,521,417,277,139,70,76,5256,1500,3756
65,83,73,41,28,13,12,1032,250,782
76,481,399,315,214,134,100,5076,1643,3433
605,229,227,146,104,91,43,2538,840,1698
4779,15,10,5,3,2,5,144,40,104
650,219,219,197,151,107,53,3264,946,2318
4966,384,314,223,141,111,76,4746,1249,3497
5427,6,6,3,2,1,1,54,19,35
382,351,320,237,168,81,86,4020,1243,2777
243,1,0,0,0,0,0,42,1,41
8548,159,140,100,61,39,27,1986,526,1460
393,243,223,165,114,68,43,2826,856,1970
421,152,120,99,62,36,27,1866,496,1370
0,0,0,0,0,0,0,0,0,0
341,5,3,2,3,0,2,90,15,75
5367,214,173,144,108,82,41,2310,762,1548
359,166,133,94,76,41,29,1938,539,1399
3603,255,233,158,123,69,59,2784,897,1887
364,8,10,6,7,4,3,114,38,76
399,12,12,6,4,1,1,186,36,150
506,97,93,65,44,29,12,1362,340,1022
511,604,570,395,283,215,126,6804,2193,4611
5992,338,213,165,99,47,40,3270,902,2368
3544,582,488,334,261,159,74,7062,1898,5164
4558,15,11,7,7,6,1,138,47,91
1270,532,421,333,232,138,75,5952,1731,4221
827,76,84,61,36,20,13,786,290,496
5340,5,6,3,5,2,1,84,22,62
748,69,60,29,19,7,5,1056,189,867
904,130,119,95,73,50,28,1572,495,1077
4445,235,200,119,79,42,41,2742,716,2026
787,1105,919,604,432,255,207,11448,3522,7926
4819,220,159,113,72,46,20,2364,630,1734
4887,15,11,11,10,4,2,132,53,79
802,11,7,5,3,3,1,90,30,60
812,84,68,54,42,25,14,936,287,649
848,258,205,163,107,72,41,3042,846,2196
4780,12,11,9,5,4,3,138,44,94
866,8,7,5,2,4,4,90,30,60
890,244,183,138,92,59,51,2832,767,2065
3459,250,217,166,109,75,36,2982,853,2129
911,3,4,4,2,2,1,54,16,38
1031,339,274,182,131,80,48,3366,1054,2312
5031,75,64,48,36,19,14,1074,256,818
1064,75,71,51,35,37,16,1206,285,921
1085,276,198,138,77,62,24,3204,775,2429
955,238,219,148,115,68,35,3024,823,2201
4919,550,455,363,234,166,73,6432,1841,4591
977,64,58,50,30,20,13,1068,235,833
1037,2,2,1,1,0,0,36,6,30
1043,389,304,178,112,95,68,4494,1146,3348
1049,20,15,7,11,7,4,174,64,110
1275,791,767,540,355,258,187,8634,2898,5736
1096,0,0,0,0,0,0,0,0,0
4809,6,10,6,4,3,4,102,33,69
1104,6,10,6,4,3,4,102,33,69
4811,1001,773,572,352,225,150,10386,3073,7313
5226,16,9,6,4,0,2,114,37,77
5218,10,7,5,4,0,3,120,29,91
5213,390,337,211,178,89,79,4680,1284,3396
1178,370,280,204,158,110,62,3756,1184,2572
1242,9,9,6,5,5,3,132,37,95
5252,214,196,131,85,76,30,2460,732,1728
1281,21,19,14,9,8,4,192,75,117
1286,14,12,10,7,9,3,168,55,113
1290,8,7,5,3,1,4,66,28,38
1294,188,173,120,96,85,36,2394,698,1696
1302,3,3,1,1,1,1,42,10,32
1329,92,73,56,42,22,11,1128,296,832
1350,133,125,101,71,37,35,1890,502,1388
1363,11,6,6,5,3,3,138,34,104
1382,245,227,181,165,113,55,2820,986,1834
1519,83,84,67,53,40,11,1236,338,898
1433,162,129,114,75,47,18,1722,545,1177
7179,0,0,0,0,0,0,264,0,264
1594,154,136,91,53,16,22,1806,472,1334
4799,151,108,72,56,31,22,1482,440,1042
5284,9,10,10,6,7,1,114,43,71
5279,7,5,3,2,0,0,90,17,73
5270,574,496,446,309,197,93,7236,2115,5121
1559,0,0,0,0,0,0,0,0,0
4768,70,60,50,42,24,16,954,262,692
1575,8,7,4,4,3,3,108,29,79
1586,374,324,218,187,101,71,4362,1275,3087
1613,58,55,51,38,13,16,876,231,645
1620,3,6,3,3,1,2,72,18,54
1624,123,104,79,49,29,25,1554,409,1145
1634,142,103,81,60,29,10,1740,425,1315
1643,3,1,1,2,1,0,36,8,28
1753,17,14,11,7,6,3,186,58,128
4954,13,13,12,8,4,3,180,53,127
1692,41,35,35,20,9,7,558,147,411
5128,348,309,223,163,75,72,3996,1190,2806
5141,219,220,158,106,90,62,2454,855,1599
1717,201,169,133,86,42,34,2448,665,1783
1725,15,11,7,3,2,1,144,39,105
1728,6,6,5,6,1,2,60,26,34
4487,799,646,434,312,211,134,8604,2536,6068
2778,66,54,53,39,19,12,948,243,705
1756,7,8,5,4,1,2,96,27,69
1885,512,507,394,253,161,108,5778,1935,3843
5144,265,251,181,125,69,63,2970,954,2016
5146,7,7,5,5,1,2,84,27,57
5147,58,54,33,31,15,5,546,196,350
5149,180,173,121,83,54,24,2250,635,1615
5152,5,4,5,4,3,1,54,22,32
3740,226,232,193,132,95,88,2772,966,1806
3815,541,397,272,138,94,63,5934,1505,4429
3742,297,282,199,147,99,55,3672,1079,2593
3744,645,590,443,301,205,129,8214,2313,5901
4752,277,220,145,106,69,39,3258,856,2402
3809,861,772,592,456,292,143,10152,3116,7036
3738,385,315,215,167,116,56,4308,1254,3054
1816,5,5,3,2,0,1,54,16,38
1819,7,7,4,3,1,2,60,24,36
3793,174,145,123,90,60,34,2016,626,1390
3772,8,8,4,1,4,1,144,26,118
3746,533,412,300,189,116,84,5934,1634,4300
1822,3,5,2,3,1,2,72,16,56
1915,9,5,3,4,2,3,78,26,52
0,0,0,0,0,0,0,0,0,0
5094,272,246,192,126,70,68,2988,974,2014
5096,7,5,6,3,2,0,78,23,55
5097,162,142,114,73,39,37,1878,567,1311
5099,7,5,6,1,0,1,84,20,64
5105,196,177,133,108,49,36,2226,699,1527
1845,98,91,72,53,35,28,1536,377,1159
1856,3,5,4,3,2,1,60,18,42
5107,542,466,299,200,133,112,6006,1752,4254
5046,351,271,229,128,83,44,3738,1106,2632
1890,11,11,5,4,2,3,102,36,66
1894,11,12,9,5,5,3,114,45,69
1907,9,7,7,4,3,3,96,33,63
4795,7,5,4,0,0,1,90,17,73
1919,300,198,131,106,50,37,3090,822,2268
2416,12,13,10,6,3,1,114,45,69
1934,9,7,8,5,2,0,90,31,59
1938,5,3,3,4,2,1,42,18,24
4902,8,4,4,3,0,3,72,22,50
4908,12,10,6,4,3,3,132,38,94
4909,8,11,7,6,2,3,108,37,71
2419,11,7,6,7,2,6,144,39,105
5039,7,6,5,1,1,2,90,22,68
5030,3,2,3,1,2,1,66,12,54
5033,3,5,3,5,1,3,54,20,34
5035,8,8,7,6,3,1,132,33,99
5002,26,22,14,7,4,3,210,76,134
4911,6,6,4,3,2,1,84,22,62
1968,187,147,114,95,57,37,2400,637,1763
4996,926,765,508,379,231,166,10140,2975,7165
0,0,0,0,0,0,0,0,0,0
4686,287,225,191,116,69,63,3540,951,2589
2100,7,6,8,3,3,0,96,27,69
1982,5,4,1,2,1,0,72,13,59
2120,9,8,7,6,6,1,102,37,65
4922,7,4,3,2,1,0,66,17,49
4924,7,8,6,5,4,1,90,31,59
4979,5,4,2,2,1,0,66,14,52
4927,287,228,175,119,66,37,3336,912,2424
4754,7,8,6,5,2,3,132,31,101
4944,5,4,3,3,2,1,54,18,36
4893,10,7,8,7,5,0,108,37,71
4899,20,17,13,6,2,2,180,60,120
4900,10,7,3,3,3,1,96,27,69
4897,18,15,12,9,4,4,150,62,88
2217,164,135,99,82,42,32,2280,554,1726
2103,5,4,2,1,0,1,78,13,65
4945,4,2,1,1,1,1,60,10,50
2107,572,574,467,320,240,146,6888,2319,4569
3788,144,146,115,97,46,36,1722,584,1138
3755,224,198,97,86,46,30,2910,681,2229
2137,255,235,176,125,87,45,2898,923,1975
3587,463,348,246,168,114,71,4554,1410,3144
4976,85,85,54,46,31,10,1218,311,907
5079,126,132,104,76,56,36,1494,530,964
2157,231,214,158,105,84,39,2904,831,2073
2161,3,4,1,0,2,0,60,10,50
2237,1,2,1,1,0,0,30,5,25
2241,6,6,2,2,2,0,72,18,54
2249,3,3,4,2,0,1,36,13,23
2298,379,307,250,174,150,77,3714,1337,2377
3002,102,98,77,57,41,27,1482,402,1080
2985,3,4,5,2,1,0,48,15,33
2987,5,4,2,1,0,0,72,12,60
2991,3,4,2,2,2,0,54,13,41
2956,269,240,175,127,82,55,3180,948,2232
2961,6,5,3,3,3,0,72,20,52
2963,14,14,10,7,4,7,150,56,94
2971,12,11,10,5,4,3,126,45,81
2980,565,489,340,234,153,89,6840,1870,4970
2342,914,855,612,457,289,179,11214,3306,7908
3582,182,166,132,111,63,23,2160,677,1483
0,0,0,0,0,0,0,0,0,0
3594,304,259,165,135,72,63,3564,998,2566
3567,429,302,193,131,70,62,4722,1187,3535
2429,9,9,6,7,3,3,90,37,53
4078,123,132,86,62,44,27,1758,474,1284
3080,118,84,54,33,30,12,1206,331,875
2439,12,12,6,5,5,3,126,43,83
5323,347,292,213,145,103,58,4140,1158,2982
3094,14,7,4,3,3,5,156,36,120
3076,10,6,6,5,4,2,90,33,57
5037,208,228,141,101,98,54,2604,830,1774
2467,305,254,178,148,100,54,3252,1039,2213
2473,8,10,7,3,6,4,132,38,94
4000,14,8,6,4,1,2,144,35,109
2475,18,15,8,8,4,3,174,56,118
2482,18,21,13,11,9,2,240,74,166
2495,349,274,201,168,98,62,3984,1152,2832
2499,7,3,6,8,4,5,90,33,57
4001,4,4,4,4,1,3,60,20,40
2501,13,13,7,6,5,1,120,45,75
2512,7,7,6,6,1,4,90,31,59
2524,238,218,156,116,66,56,2928,850,2078
8697,95,80,51,34,25,19,1128,304,824
2775,18,11,10,4,2,6,270,51,219
3422,386,342,238,178,114,76,4494,1334,3160
2617,896,787,574,423,288,134,11046,3102,7944
2642,190,155,111,80,37,32,2142,605,1537
3270,26,26,25,12,10,5,384,104,280
3614,555,490,441,308,240,75,8040,2109,5931
2649,11,11,7,8,6,3,120,46,74
5320,448,373,297,215,137,77,5406,1547,3859
3597,5,3,2,4,2,0,42,16,26
3601,68,57,44,36,25,15,1212,245,967
3598,7,6,1,2,0,3,72,19,53
2667,9,6,6,6,5,3,108,35,73
4017,197,146,98,56,35,24,1926,556,1370
2690,790,720,477,363,245,130,10074,2725,7349
2938,263,266,237,179,126,54,3600,1125,2475
2706,10,9,4,4,3,3,96,33,63
2716,10,8,6,5,4,2,102,35,67
2720,9,6,4,5,1,1,84,26,58
4060,214,173,144,105,50,46,2892,732,2160
3606,219,185,125,99,61,35,2592,724,1868
2784,365,350,277,208,111,92,4548,1403,3145
0,0,0,0,0,0,0,0,0,0
3031,265,198,139,90,64,29,2748,785,1963
3041,16,10,8,5,1,2,144,42,102
3043,9,7,7,5,3,2,72,33,39
3453,198,143,105,85,40,31,2106,602,1504
3203,363,350,258,226,134,100,4188,1431,2757
3230,110,86,60,42,28,15,1296,341,955
3475,497,455,326,237,133,100,5868,1748,4120
3497,154,135,86,57,25,27,1776,484,1292
4925,457,373,267,159,110,73,4752,1439,3313
3410,151,120,130,87,62,28,2142,578,1564
3451,165,166,124,81,50,28,1980,614,1366
3466,181,167,124,107,74,30,2346,683,1663
3444,176,158,141,86,71,38,2310,670,1640
3446,453,400,271,211,110,95,5478,1540,3938
3489,211,179,151,99,68,39,2622,747,1875
3555,271,209,145,132,76,51,3036,884,2152
3455,8,7,6,6,4,1,96,32,64
3456,11,11,8,6,3,3,108,42,66
3462,9,10,8,6,4,2,126,39,87
3464,183,156,112,82,41,36,2100,610,1490
3472,8,5,1,1,0,2,90,17,73
3640,204,155,98,81,45,39,2592,622,1970
3619,367,337,226,183,113,54,4188,1280,2908
3599,37,42,28,21,12,11,768,151,617
3483,698,616,473,350,258,94,7656,2489,5167
3487,234,209,123,86,44,39,2388,735,1653
3520,157,137,87,75,38,21,1794,515,1279
3495,215,182,118,83,44,29,2484,671,1813
3529,135,125,97,68,46,31,1962,502,1460
3621,252,212,155,106,63,44,3264,832,2432
3501,13,11,6,3,1,3,114,37,77
3504,9,10,4,5,3,0,120,31,89
3510,7,7,6,5,3,1,126,29,97
3513,6,7,5,4,2,1,84,25,59
3516,1750,1395,1003,678,375,248,18552,5449,13103
3518,369,326,229,159,120,50,4236,1253,2983
3523,326,255,193,148,72,60,4116,1054,3062
3525,303,257,213,137,102,62,3708,1074,2634
3527,243,228,165,119,63,47,2874,865,2009
3532,119,105,89,54,35,18,1542,420,1122
3537,815,678,437,351,189,142,9636,2612,7024
3546,92,79,54,40,26,12,1080,303,777
3623,363,344,252,187,122,64,4980,1332,3648
3638,186,168,116,63,54,47,2064,634,1430
3645,171,163,135,114,75,38,2490,696,1794
3651,223,188,173,138,98,32,3270,852,2418
3672,121,81,48,32,13,20,1560,315,1245
3659,361,289,211,138,106,33,3846,1138,2708
3663,105,93,58,63,21,34,1542,374,1168
3666,189,154,91,83,29,41,2418,587,1831
3679,532,554,390,314,220,136,6510,2146,4364
3670,220,187,103,77,43,41,2646,671,1975
3688,91,76,53,62,39,35,1464,356,1108
3675,1205,992,753,556,346,190,12966,4042,8924
3677,41,34,27,23,8,8,654,141,513
3683,169,159,90,52,38,42,2214,550,1664
3690,9,8,8,8,5,1,132,39,93
3692,9,8,8,8,5,1,132,39,93
3697,117,105,71,65,29,28,1380,415,965
3700,590,507,369,288,194,138,7188,2086,5102
3705,3,4,3,2,1,1,54,14,40
3706,10,8,5,3,1,4,114,31,83
3709,192,154,125,81,49,37,2466,638,1828
3722,72,65,40,28,16,14,906,235,671
3724,157,154,107,81,53,38,1818,590,1228
3726,364,331,266,174,123,58,4956,1316,3640
3729,469,393,279,195,114,85,5298,1535,3763
3818,96,98,75,54,29,15,1326,367,959
3848,107,74,47,29,16,13,1284,286,998
3822,569,499,317,226,147,79,7386,1837,5549
3824,100,86,40,44,35,19,1326,324,1002
3899,31,22,13,7,7,8,378,88,290
3859,509,397,329,209,133,51,5538,1628,3910
3836,95,70,37,22,13,26,1116,263,853
3902,410,378,303,235,185,79,4974,1590,3384
0,0,0,0,0,0,0,0,0,0
3842,600,590,342,277,166,134,6180,2109,4071
3846,236,252,208,131,103,63,2598,993,1605
3878,245,229,171,120,82,66,2634,913,1721
3855,134,100,80,50,37,20,1434,421,1013
3863,919,780,470,331,200,178,10446,2878,7568
6861,418,365,280,181,129,75,4752,1448,3304
4005,81,48,35,17,14,10,996,205,791
3897,112,94,78,61,38,11,1590,394,1196
3910,91,38,58,35,31,11,1224,264,960
0,0,0,0,0,0,0,0,0,0
3892,236,220,170,101,78,43,3336,848,2488
3894,374,303,221,145,91,48,3918,1182,2736
3906,322,279,177,145,78,50,4248,1051,3197
3908,138,140,109,87,62,26,1866,562,1304
0,0,0,0,0,0,0,0,0,0
0,0,0,0,0,0,0,0,0,0
0,0,0,0,0,0,0,0,0,0
3926,7,9,8,7,5,2,108,38,70
3927,12,11,6,5,6,0,126,40,86
3929,89,48,37,24,14,11,1110,223,887
3931,451,387,332,215,120,93,5700,1598,4102
3933,235,190,144,98,58,28,2448,753,1695
0,0,0,0,0,0,0,0,0,0
0,0,0,0,0,0,0,0,0,0
3958,315,255,171,114,80,39,3696,974,2722
3944,6,6,3,2,1,1,78,19,59
3947,12,13,6,2,2,0,156,35,121
3962,7,4,5,2,1,2,90,21,69
3969,16,13,8,5,4,2,150,48,102
0,0,0,0,0,0,0,0,0,0
0,0,0,0,0,0,0,0,0,0
3980,129,118,81,52,39,20,1668,439,1229
3982,128,114,94,76,57,16,1596,485,1111
4043,12,14,9,10,4,5,132,54,78
4015,27,23,22,18,12,9,342,111,231
4012,22,17,10,9,3,2,228,63,165
4009,18,18,11,8,4,4,174,63,111
4010,17,18,12,8,8,2,192,65,127
4011,22,17,10,9,3,2,228,63,165
3995,617,520,341,247,164,85,7140,1974,5166
4024,16,16,8,5,1,2,156,48,108
4064,495,343,234,188,93,105,5220,1458,3762
0,0,0,0,0,0,0,0,0,0
0,0,0,0,0,0,0,0,0,0
0,0,0,0,0,0,0,0,0,0
4036,208,121,123,80,29,34,2832,595,2237
4044,15,12,9,6,4,2,144,48,96
4051,11,10,11,8,7,2,132,49,83
4053,12,7,4,2,2,1,102,28,74
4056,439,425,349,252,175,58,5940,1698,4242
4058,536,488,394,308,212,59,6630,1997,4633
4067,197,169,111,74,48,42,2508,641,1867
4069,310,234,218,124,81,40,3648,1007,2641
6413,233,199,181,132,91,34,3252,870,2382
4184,441,316,244,146,82,79,4758,1308,3450
4098,222,196,154,130,67,51,3108,820,2288
4100,269,231,175,132,92,42,3498,941,2557
4103,589,501,404,274,160,84,8004,2012,5992
4124,8,6,5,2,3,3,102,27,75
4125,20,15,13,5,1,2,180,56,124
4129,12,12,9,8,5,5,174,51,123
4131,9,8,7,5,3,0,96,32,64
4133,8,9,9,6,4,3,138,39,99
4134,5,4,4,2,2,0,78,17,61
4136,12,10,10,6,4,0,114,42,72
4147,16,15,10,6,7,0,192,54,138
4151,155,113,69,47,30,23,1638,437,1201
4271,41,23,19,14,5,2,384,104,280
0,0,0,0,0,0,0,0,0,0
4158,8,7,7,7,5,3,108,37,71
0,0,0,0,0,0,0,0,0,0
0,0,0,0,0,0,0,0,0,0
0,0,0,0,0,0,0,0,0,0
0,0,0,0,0,0,0,0,0,0
4217,267,225,154,97,59,55,3078,857,2221
4190,5,4,2,1,3,2,42,17,25
4281,742,595,412,291,173,142,8664,2355,6309
4284,323,265,200,147,104,56,3864,1095,2769
4254,22,16,10,7,5,5,246,65,181
4255,12,9,6,2,1,1,186,31,155
4260,78,79,60,34,22,17,1158,290,868
4269,355,292,218,151,79,64,4164,1159,3005
4273,183,172,139,86,56,33,2250,669,1581
10374,200,194,150,104,68,34,2670,750,1920
4305,188,141,93,82,41,24,1998,569,1429
4307,8,7,2,2,3,1,60,23,37
4310,6,7,2,2,3,1,72,21,51
4311,1,2,2,2,1,1,24,9,15
4313,16,13,9,6,3,4,132,51,81
4316,3,4,4,3,1,0,54,15,39
4321,15,10,8,8,4,5,180,50,130
4325,7,9,8,5,2,2,108,33,75
4399,557,497,392,301,183,139,7494,2069,5425
4327,11,10,8,7,2,2,132,40,92
4334,156,129,89,68,45,26,2034,513,1521
4443,357,318,215,163,103,74,3606,1230,2376
4387,325,245,183,135,77,58,3684,1023,2661
4397,5,7,6,5,2,3,60,28,32
4401,6,5,5,3,1,3,72,23,49
4403,6,6,3,5,3,2,60,25,35
4404,15,11,8,7,5,2,120,48,72
4406,3,3,1,1,1,1,30,10,20
4412,5,3,2,1,2,2,60,15,45
4414,1,2,1,1,0,1,42,6,36
4416,8,6,3,2,1,1,108,21,87
4417,7,7,6,5,3,2,72,30,42
4420,2,2,3,0,1,0,48,8,40
4421,2,2,3,0,1,0,48,8,40
4422,226,192,158,117,53,45,2466,791,1675
4483,188,151,101,61,42,26,2184,569,1615
4432,12,5,7,4,1,2,90,31,59
4433,8,5,4,2,2,2,90,23,67
4436,4,5,2,1,2,0,90,14,76
4440,7,11,5,2,2,2,90,29,61
4519,175,156,115,93,65,40,2538,644,1894
4476,67,65,52,44,25,13,936,266,670
4478,13,13,9,8,3,0,180,46,134
4480,7,8,7,6,5,4,90,37,53
4481,4,7,4,4,1,1,108,21,87
4482,4,7,4,4,1,1,102,21,81
4506,8,7,5,3,0,3,84,26,58
4508,5,4,1,3,0,3,66,16,50
4509,13,14,9,2,4,4,138,46,92
4516,7,8,5,4,3,1,78,28,50
4554,250,188,146,79,45,29,2712,737,1975
4524,143,110,79,62,28,16,1584,438,1146
4543,5,5,6,2,3,2,102,23,79
4548,4,6,0,2,1,2,84,15,69
4556,186,177,114,74,51,35,2394,637,1757
4595,191,137,90,66,40,26,2118,550,1568
4603,625,495,388,281,164,84,6816,2037,4779
4605,8,6,7,1,1,1,96,24,72
4607,11,10,6,5,1,2,120,35,85
4609,8,6,4,3,1,2,72,24,48
4612,13,11,5,3,1,2,120,35,85
4613,6,7,4,2,2,1,54,22,32
4623,11,10,8,6,3,0,120,38,82
4626,4,5,3,4,1,4,66,21,45
4628,11,9,6,8,4,0,114,38,76
4630,12,8,6,6,1,1,108,34,74
4632,13,10,10,4,2,4,126,43,83
4635,410,306,205,154,87,68,4392,1230,3162
4641,7,7,7,5,4,2,120,32,88
4646,10,8,5,4,2,3,108,32,76
4648,15,11,7,3,2,0,132,38,94
4649,289,277,269,194,125,55,4632,1209,3423
4651,0,0,0,0,0,0,0,0,0
4668,10,8,5,3,2,0,120,28,92
4670,7,7,4,7,4,0,156,29,127
4673,2,4,4,2,1,1,60,14,46
4674,8,8,7,3,2,1,120,29,91
4677,10,6,5,6,3,4,138,34,104
4678,10,6,5,6,3,4,132,34,98
4750,179,190,118,99,50,35,2208,671,1537
4682,156,147,124,82,76,29,2292,614,1678
4734,5,4,1,1,1,1,60,13,47
4755,34,30,20,14,5,4,396,107,289
4735,19,11,14,6,2,3,168,55,113
4736,10,6,5,4,0,1,102,26,76
4737,132,118,93,63,46,51,1674,503,1171
4738,6,5,3,4,1,1,108,20,88
4740,10,13,5,5,1,3,108,37,71
4741,5,6,2,0,0,0,54,13,41
4745,12,14,12,11,6,3,150,58,92
4770,5,5,7,5,2,1,96,25,71
4772,10,9,5,5,1,3,114,33,81
4797,5,6,2,3,0,0,66,16,50
4801,13,11,8,2,2,2,114,38,76
4872,1642,1296,893,561,336,213,17064,4941,12123
4813,9,8,7,5,3,2,96,34,62
4816,11,8,7,7,4,3,144,40,104
4817,11,5,3,3,1,4,102,27,75
4875,39,30,16,10,4,5,510,104,406
5923,372,376,266,186,104,111,4536,1415,3121
6491,537,546,405,293,219,80,6636,2080,4556
5547,98,81,50,40,19,17,1152,305,847
5596,284,273,172,121,79,56,3198,985,2213
5607,12,10,6,6,3,1,126,38,88
5625,15,14,9,9,5,5,156,57,99
5703,69,46,36,28,19,12,648,210,438
5802,60,47,34,31,14,11,726,197,529
5843,149,65,74,52,17,18,1788,375,1413
5856,970,780,541,369,222,193,10554,3075,7479
5860,10,9,8,7,4,1,114,39,75
5861,8,5,5,4,6,1,114,29,85
5862,11,10,5,3,4,1,102,34,68
5885,218,210,190,147,83,38,3078,886,2192
5888,7,8,8,3,0,2,102,28,74
5918,7,8,3,5,5,0,120,28,92
5919,276,225,136,117,54,59,3288,867,2421
5922,3,1,0,0,0,0,30,4,26
5925,251,181,123,99,49,53,2436,756,1680
5927,17,14,7,7,3,4,156,52,104
5945,148,109,65,49,37,9,1662,417,1245
5947,596,463,314,217,134,78,6180,1802,4378
5951,319,244,167,152,92,50,3186,1024,2162
5955,164,141,91,67,47,29,2154,539,1615
5957,387,378,302,213,156,93,6210,1529,4681
5959,4,6,6,3,1,2,54,22,32
5961,7,9,6,6,6,2,96,36,60
5962,8,11,7,8,6,3,132,43,89
5963,8,8,7,3,3,1,120,30,90
5964,8,8,7,3,3,1,120,30,90
5981,229,220,202,131,90,55,3678,927,2751
5983,153,117,72,57,32,16,1626,447,1179
5986,17,13,11,6,4,4,150,55,95
5995,19,12,11,4,2,2,186,50,136
6015,108,103,86,54,31,24,1260,406,854
6018,349,342,264,217,138,65,4446,1375,3071
6021,12,12,11,7,4,2,150,48,102
6408,187,145,110,86,50,30,2190,608,1582
6025,154,111,84,48,24,19,1746,440,1306
6027,2,2,2,0,0,2,36,8,28
6028,308,227,159,99,69,52,3150,914,2236
6030,9,6,4,4,0,2,102,25,77
6054,254,277,256,198,127,45,4116,1157,2959
6056,7,9,7,5,3,1,108,32,76
6058,5,7,5,4,5,4,108,30,78
6063,679,635,475,339,231,118,8052,2477,5575
6066,8,9,7,7,5,2,114,38,76
6083,186,137,92,72,41,26,2226,554,1672
6087,267,197,149,106,55,46,3072,820,2252
6092,0,0,0,0,0,0,54,0,54
6114,116,81,58,39,28,14,1308,336,972
6119,128,109,80,56,40,15,1770,428,1342
6121,311,292,220,165,107,59,4104,1154,2950
6144,320,275,181,125,69,51,4044,1021,3023
6147,156,142,89,55,36,19,1812,497,1315
6155,50,40,32,25,20,16,882,183,699
6157,28,25,12,5,8,3,432,81,351
6176,291,216,170,119,79,40,3678,915,2763
6178,146,123,100,61,35,34,1938,499,1439
6184,589,509,373,267,209,124,6996,2071,4925
6204,59,43,26,19,12,7,876,166,710
6206,399,341,246,190,99,69,4596,1344,3252
6208,4,6,6,3,1,2,54,22,32
6209,11,10,12,8,5,5,126,51,75
6230,324,268,241,148,104,58,4188,1143,3045
6232,9,7,9,6,6,2,108,39,69
6233,9,7,9,6,6,2,108,39,69
6238,239,163,120,66,33,23,2622,644,1978
6240,11,9,8,3,2,1,120,34,86
6244,10,9,7,5,2,1,114,34,80
6245,26,22,13,8,4,9,312,82,230
6262,611,519,316,191,103,95,6234,1835,4399
6264,244,192,144,93,78,35,3006,786,2220
6268,324,298,244,167,117,48,3990,1198,2792
6272,4,6,3,2,1,0,84,16,68
6273,27,19,12,8,1,9,342,76,266
6292,51,43,37,26,13,9,672,179,493
6295,258,206,105,76,42,47,3138,734,2404
6298,136,115,81,62,31,27,1704,452,1252
6301,1,3,5,2,1,2,42,14,28
6302,10,8,5,2,2,4,102,31,71
6303,230,195,122,91,52,28,2460,718,1742
6305,593,513,399,290,227,88,7002,2110,4892
6332,55,47,31,26,10,5,552,174,378
6334,483,404,351,281,238,71,5646,1828,3818
6337,7,5,3,3,3,1,78,22,56
6338,10,7,3,2,0,0,120,22,98
6340,213,207,174,118,87,44,3108,843,2265
6343,7,6,6,6,3,3,102,31,71
6345,5,5,7,3,1,0,114,21,93
6348,7,7,6,4,1,1,96,26,70
6349,141,105,79,52,38,23,1608,438,1170
6354,254,227,132,105,57,48,2988,823,2165
6356,183,164,112,82,81,31,2082,653,1429
6360,1,2,1,2,0,3,36,9,27
6372,100,72,51,43,28,14,1224,308,916
6375,20,12,9,5,3,4,168,53,115
0,0,0,0,0,0,0,0,0,0
0,0,0,0,0,0,0,0,0,0
6378,361,336,235,155,116,87,4056,1290,2766
6380,16,18,12,7,8,2,180,63,117
6382,8,10,6,3,4,2,90,33,57
6383,298,294,208,160,124,48,3636,1132,2504
6385,12,12,10,9,5,3,114,51,63
6386,5,5,5,4,3,1,60,23,37
6416,10,8,6,3,1,3,120,31,89
6418,4,4,4,6,1,2,84,21,63
6425,40,34,25,19,15,7,576,140,436
6444,9,5,4,1,0,1,72,20,52
6446,116,103,72,45,32,18,1398,386,1012
0,0,0,0,0,0,0,0,0,0
0,0,0,0,0,0,0,0,0,0
0,0,0,0,0,0,0,0,0,0
0,0,0,0,0,0,0,0,0,0
0,0,0,0,0,0,0,0,0,0
0,0,0,0,0,0,0,0,0,0
0,0,0,0,0,0,0,0,0,0
0,0,0,0,0,0,0,0,0,0
0,0,0,0,0,0,0,0,0,0
0,0,0,0,0,0,0,0,0,0
0,0,0,0,0,0,0,0,0,0
0,0,0,0,0,0,0,0,0,0
0,0,0,0,0,0,0,0,0,0
6496,12,13,8,5,6,4,132,48,84
6499,10,10,7,3,1,0,126,31,95
6518,12,9,8,6,4,2,120,41,79
6519,7,7,4,4,3,3,90,28,62
6527,67,75,51,48,34,21,846,296,550
6529,7,8,6,7,3,1,90,32,58
6530,204,145,108,73,47,22,2244,599,1645
6532,18,12,10,9,5,2,162,56,106
6533,6,7,5,6,1,1,72,26,46
6534,4,2,3,0,0,1,42,10,32
6535,301,255,184,159,94,46,3552,1039,2513
6538,6,5,6,4,2,1,90,24,66
6544,140,140,126,88,57,29,2364,580,1784
6563,30,25,18,14,14,10,396,111,285
6565,5,6,6,1,2,2,90,22,68
8417,141,132,107,80,59,23,1932,542,1390
0,0,0,0,0,0,0,0,0,0
6611,182,170,141,122,95,25,2616,735,1881
6617,5,4,7,7,6,3,96,32,64
6619,85,57,42,37,20,8,1080,249,831
6636,262,233,161,127,72,54,3108,909,2199
6647,10,9,6,5,3,0,132,33,99
6650,214,220,176,127,92,37,2988,866,2122
6648,12,10,6,3,2,3,108,36,72
6652,4,2,1,2,1,1,72,11,61
6653,11,11,5,5,7,0,126,39,87
6654,11,16,13,9,6,3,150,58,92
6655,6,7,7,7,7,1,108,35,73
0,0,0,0,0,0,0,0,0,0
6678,147,126,101,96,36,45,1656,551,1105
6680,190,187,130,80,68,43,2598,698,1900
6693,108,87,65,50,25,19,1284,354,930
6696,4,3,3,3,0,3,66,16,50
6697,0,0,1,0,0,0,12,1,11
6698,5,3,3,1,1,0,78,13,65
6702,13,13,11,10,4,5,132,56,76
6706,15,12,9,7,2,4,144,49,95
6707,8,6,3,4,0,2,102,23,79
6712,10,7,8,6,3,1,144,35,109
6714,14,6,4,5,2,1,114,32,82
6716,6,7,7,6,1,0,96,27,69
6717,6,10,5,1,3,1,90,26,64
6718,294,285,214,180,115,65,3906,1153,2753
6720,7,6,6,2,1,1,84,23,61
0,0,0,0,0,0,0,0,0,0
0,0,0,0,0,0,0,0,0,0
0,0,0,0,0,0,0,0,0,0
0,0,0,0,0,0,0,0,0,0
0,0,0,0,0,0,0,0,0,0
0,0,0,0,0,0,0,0,0,0
0,0,0,0,0,0,0,0,0,0
0,0,0,0,0,0,0,0,0,0
0,0,0,0,0,0,0,0,0,0
0,0,0,0,0,0,0,0,0,0
0,0,0,0,0,0,0,0,0,0
0,0,0,0,0,0,0,0,0,0
0,0,0,0,0,0,0,0,0,0
0,0,0,0,0,0,0,0,0,0
0,0,0,0,0,0,0,0,0,0
6799,181,162,124,95,50,20,2304,632,1672
6802,52,53,44,26,17,12,828,204,624
6804,239,202,169,132,93,35,2712,870,1842
6808,173,135,78,56,41,35,2106,518,1588
6844,0,0,0,0,0,0,0,0,0
6846,4,2,3,1,0,1,54,11,43
6847,19,16,15,7,2,3,162,62,100
6858,0,0,0,0,0,0,24,0,24
6892,88,67,61,43,30,13,1068,302,766
6915,0,0,0,0,0,0,48,0,48
8442,206,157,108,78,43,33,2298,625,1673
6917,327,263,199,141,86,44,4044,1060,2984
6920,11,9,8,5,3,2,108,38,70
6923,4,4,4,2,0,1,60,15,45
6959,94,71,51,45,17,16,1176,294,882
6962,235,187,127,87,65,62,2514,763,1751
6964,13,9,5,3,5,5,108,40,68
6965,11,8,5,2,5,2,120,33,87
6966,0,0,0,0,0,0,30,0,30
6968,5,4,3,5,2,0,78,19,59
6970,1541,1319,1031,712,461,244,17970,5308,12662
6972,9,8,8,4,3,2,102,34,68
6973,9,9,7,3,2,1,138,31,107
6977,12,14,13,8,5,1,132,53,79
6979,8,8,9,3,1,1,90,30,60
6982,5,4,3,0,0,0,78,12,66
6983,4,4,6,2,1,1,90,18,72
6999,209,164,116,89,45,31,2934,654,2280
7015,116,105,99,63,74,37,1686,494,1192
7029,220,199,165,124,89,17,3330,814,2516
7031,5,5,4,1,1,0,60,16,44
7047,221,194,131,85,38,34,2328,703,1625
7049,13,10,9,6,2,2,120,42,78
7051,485,383,281,211,126,88,5856,1574,4282
7053,10,10,6,8,4,1,108,39,69
7057,7,7,6,4,0,1,66,25,41
7083,596,559,416,299,216,96,6540,2182,4358
7085,7,9,4,5,1,2,90,28,62
7086,3,2,2,2,0,0,48,9,39
7087,17,18,14,9,7,2,168,67,101
7089,256,213,137,90,58,36,2976,790,2186
7122,12,15,6,4,4,2,114,43,71
7125,14,11,5,2,2,0,144,34,110
7136,72,70,56,41,21,8,1002,268,734
7141,14,11,10,3,1,0,162,39,123
7142,12,11,5,7,2,3,126,40,86
7145,15,7,5,1,0,3,144,31,113
7146,12,12,5,1,2,3,102,35,67
7181,3,5,4,3,0,1,66,16,50
7189,367,336,235,172,110,69,4416,1289,3127
7192,11,12,7,5,2,3,138,40,98
7197,4,6,3,4,0,2,60,19,41
0,0,0,0,0,0,0,0,0,0
0,0,0,0,0,0,0,0,0,0
0,0,0,0,0,0,0,0,0,0
0,0,0,0,0,0,0,0,0,0
0,0,0,0,0,0,0,0,0,0
0,0,0,0,0,0,0,0,0,0
0,0,0,0,0,0,0,0,0,0
0,0,0,0,0,0,0,0,0,0
0,0,0,0,0,0,0,0,0,0
7241,8,6,4,2,1,2,72,23,49
7242,235,211,164,107,73,51,2826,841,1985
7249,0,0,0,0,0,0,48,0,48
7251,44,36,27,17,9,10,504,143,361
7253,6,6,6,6,4,0,96,28,68
7271,672,556,456,303,173,128,8268,2288,5980
7273,14,12,10,6,5,0,132,47,85
7274,16,14,10,7,4,0,168,51,117
7275,6,8,5,4,5,5,96,33,63
7276,185,170,131,89,51,59,2076,685,1391
7278,425,404,348,265,189,68,6408,1699,4709
7280,10,8,6,3,4,1,144,32,112
7281,7,12,8,4,5,3,126,39,87
7282,9,8,7,7,6,0,138,37,101
7283,172,155,104,74,51,16,2352,572,1780
7353,138,103,76,59,24,20,1512,420,1092
7371,183,156,125,91,65,36,2190,656,1534
7374,252,215,154,109,60,44,2934,834,2100
7376,11,9,5,4,4,1,84,34,50
7378,68,61,41,34,15,15,912,234,678
7380,656,585,449,353,214,91,8502,2348,6154
7385,9,10,7,7,4,0,114,37,77
7388,9,6,3,1,2,1,132,22,110
7389,13,8,7,5,3,4,150,40,110
7436,204,155,124,82,57,30,2454,652,1802
7439,3,3,4,1,1,0,60,12,48
7440,194,155,120,84,50,28,2394,631,1763
7442,9,6,7,6,1,1,108,30,78
7452,282,196,151,92,58,36,3084,815,2269
7456,5,7,6,5,2,2,90,27,63
7479,98,111,78,53,57,18,1194,415,779
7495,261,206,126,121,58,46,2856,818,2038
7497,6,6,3,3,1,0,96,19,77
7499,11,9,4,5,1,2,90,32,58
7500,13,12,6,5,2,3,132,41,91
7503,590,511,378,246,168,76,7194,1969,5225
7505,6,6,4,7,2,1,102,26,76
7507,6,8,5,5,2,1,102,27,75
7509,157,158,108,85,55,32,2046,595,1451
7514,8,8,7,3,4,3,138,33,105
7518,2,3,2,1,0,0,30,8,22
7520,111,108,95,64,46,15,1710,439,1271
7522,10,10,6,5,2,0,126,33,93
7567,9,10,9,7,8,1,132,44,88
7570,7,6,3,0,1,1,90,18,72
7573,281,249,183,117,94,41,4008,965,3043
7576,250,231,181,144,92,53,3210,951,2259
7581,129,99,58,47,30,29,1440,392,1048
7583,3,3,2,0,0,0,24,8,16
7584,152,124,98,72,45,21,1530,512,1018
7587,5,4,4,5,1,2,54,21,33
8411,67,65,45,43,30,11,882,261,621
7628,139,113,65,53,26,25,1938,421,1517
7633,195,144,122,86,56,21,2340,624,1716
7635,9,6,7,5,3,0,84,30,54
7636,317,310,238,179,130,44,4212,1218,2994
7638,3,2,2,1,1,1,30,10,20
7665,762,665,482,325,214,102,8634,2550,6084
7650,427,403,294,216,156,88,4884,1584,3300
7663,128,109,68,49,19,15,1236,388,848
7669,12,10,6,4,2,0,102,34,68
7670,14,10,9,7,2,1,144,43,101
7680,161,140,114,97,74,15,2154,601,1553
7701,274,265,196,138,100,42,3882,1015,2867
7704,7,5,5,2,4,1,108,24,84
7706,6,10,6,6,1,3,90,32,58
7707,149,103,66,62,16,35,1668,431,1237
7718,6,3,1,1,0,0,60,11,49
7733,8,8,4,4,5,1,102,30,72
7735,17,16,11,9,8,3,156,64,92
7736,9,10,7,5,3,2,114,36,78
7743,130,121,75,58,32,18,1548,434,1114
7745,7,7,4,5,3,0,102,26,76
7746,4,4,2,3,0,1,36,14,22
7747,14,17,9,8,5,3,138,56,82
7748,8,6,6,4,4,1,90,29,61
7752,8,5,3,1,1,0,54,18,36
7753,6,9,5,4,1,1,120,26,94
7754,6,9,5,4,1,1,120,26,94
7755,207,254,111,59,19,73,2352,723,1629
7855,82,78,56,48,33,18,1206,315,891
7857,41,32,21,13,8,4,450,119,331
7863,20,16,14,6,5,1,156,62,94
7868,109,98,86,59,36,26,1392,414,978
7872,7,5,3,4,2,1,90,22,68
7875,6,6,8,3,2,0,144,25,119
7876,10,6,4,5,2,2,84,29,55
7877,7,7,3,4,1,2,102,24,78
7879,232,188,133,98,42,49,2796,742,2054
7887,5,5,4,1,0,0,48,15,33
7888,10,8,6,4,2,2,138,32,106
7897,534,430,335,209,150,95,6276,1753,4523
7899,19,14,9,5,6,2,156,55,101
7901,15,11,8,3,3,0,156,40,116
7904,11,9,7,4,2,1,138,34,104
7908,259,207,143,85,54,35,3150,783,2367
7910,9,10,9,6,4,4,120,42,78
7913,258,240,194,151,115,34,3366,992,2374
7918,11,9,6,6,2,1,132,35,97
7934,306,276,272,171,109,57,4242,1191,3051
7936,12,7,6,4,1,1,120,31,89
7937,6,7,5,4,1,3,84,26,58
7941,224,177,113,90,41,47,2802,692,2110
7944,2,1,1,0,0,0,18,4,14
7950,3,2,2,0,0,0,30,7,23
7951,101,98,78,65,47,9,1170,398,772
7955,4,3,5,3,2,1,84,18,66
7956,10,9,7,6,4,4,90,40,50
7957,15,14,12,5,9,4,186,59,127
7972,118,97,79,61,28,37,1608,420,1188
7974,13,6,9,5,4,3,132,40,92
7976,12,10,7,6,3,0,126,38,88
7981,103,110,76,67,36,27,1590,419,1171
7984,275,260,193,132,104,54,3042,1018,2024
7990,5,5,6,3,4,2,72,25,47
15061,163,126,88,49,35,24,1998,485,1513
0,0,0,0,0,0,0,0,0,0
8100,206,192,134,92,64,46,2376,734,1642
8106,9,8,4,3,1,1,72,26,46
8107,386,363,285,226,146,83,5550,1489,4061
8110,8,5,7,2,0,0,138,22,116
8111,9,8,7,6,3,1,132,34,98
8115,9,11,8,5,4,2,144,39,105
8117,88,78,56,36,29,9,984,296,688
8119,320,284,254,193,142,39,4596,1232,3364
8121,11,7,3,4,2,2,120,29,91
8123,15,14,11,11,9,3,174,63,111
8124,3,3,3,1,0,1,36,11,25
8125,204,184,147,89,49,45,2628,718,1910
8127,6,5,4,3,3,0,78,21,57
0,0,0,0,0,0,0,0,0,0
0,0,0,0,0,0,0,0,0,0
0,0,0,0,0,0,0,0,0,0
0,0,0,0,0,0,0,0,0,0
0,0,0,0,0,0,0,0,0,0
0,0,0,0,0,0,0,0,0,0
0,0,0,0,0,0,0,0,0,0
0,0,0,0,0,0,0,0,0,0
0,0,0,0,0,0,0,0,0,0
0,0,0,0,0,0,0,0,0,0
0,0,0,0,0,0,0,0,0,0
0,0,0,0,0,0,0,0,0,0
0,0,0,0,0,0,0,0,0,0
0,0,0,0,0,0,0,0,0,0
8162,418,349,257,156,105,56,4584,1341,3243
8166,14,10,11,6,2,3,144,46,98
8167,83,83,60,46,31,18,978,321,657
8170,229,219,156,122,87,47,3246,860,2386
8174,7,7,5,4,0,1,132,24,108
8175,8,8,6,4,3,1,120,30,90
8178,478,466,315,238,180,68,6252,1745,4507
8180,113,103,73,52,37,28,1062,406,656
8188,13,16,13,11,9,1,156,63,93
8190,10,6,4,2,4,4,66,30,36
8192,204,195,149,104,70,38,2820,760,2060
8196,10,10,11,6,3,3,132,43,89
8197,7,7,3,1,0,1,66,19,47
8206,382,298,193,135,62,44,4122,1114,3008
0,0,0,0,0,0,0,0,0,0
8254,377,316,235,128,92,59,4062,1207,2855
8256,10,11,6,3,3,2,102,35,67
8257,13,14,8,3,4,1,150,43,107
8258,239,204,144,103,55,48,2760,793,1967
8260,9,11,9,5,2,4,114,40,74
8263,13,11,8,8,4,4,150,48,102
8265,136,116,86,62,40,20,1974,460,1514
8267,5,5,3,2,1,0,48,16,32
14977,148,117,77,52,34,20,1842,448,1394
8284,136,144,100,79,40,33,1848,532,1316
8286,9,11,8,5,2,2,126,37,89
8289,9,11,7,7,5,0,132,39,93
8290,4,4,2,3,0,2,30,15,15
8291,144,90,87,49,28,17,1680,415,1265
8293,251,222,164,111,64,47,2628,859,1769
8295,14,12,5,4,0,4,138,39,99
8299,306,265,161,125,61,72,3600,990,2610
8304,4,3,2,1,0,1,36,11,25
8306,7,7,5,2,2,1,72,24,48
8307,95,87,79,58,38,27,1542,384,1158
8329,166,124,78,58,39,27,1746,492,1254
8332,291,237,172,115,52,47,3456,914,2542
8338,7,1,2,2,1,0,84,13,71
8341,12,10,3,3,3,1,84,32,52
8344,9,8,2,4,1,3,90,27,63
8345,250,218,159,123,76,37,2496,863,1633
8347,15,9,7,8,4,0,114,43,71
8349,389,306,246,165,110,58,4758,1274,3484
8355,9,10,5,4,1,1,132,30,102
8358,7,9,6,5,3,1,90,31,59
8359,13,12,10,7,6,1,150,49,101
8361,6,6,4,3,1,0,72,20,52
0,0,0,0,0,0,0,0,0,0
0,0,0,0,0,0,0,0,0,0
8404,8,8,6,5,3,2,78,32,46
8406,11,10,5,2,0,0,108,28,80
8408,12,9,5,5,4,1,132,36,96
8409,13,11,6,3,4,3,126,40,86
0,0,0,0,0,0,0,0,0,0
0,0,0,0,0,0,0,0,0,0
0,0,0,0,0,0,0,0,0,0
0,0,0,0,0,0,0,0,0,0
0,0,0,0,0,0,0,0,0,0
0,0,0,0,0,0,0,0,0,0
8434,120,107,97,68,44,23,1542,459,1083
8436,11,5,6,3,1,1,126,27,99
8437,10,7,3,3,1,1,102,25,77
8438,233,185,138,117,71,39,2790,783,2007
8440,4,6,4,5,3,4,84,26,58
8444,6,3,3,2,1,1,78,16,62
8445,6,3,3,2,1,1,78,16,62
8446,5,3,2,1,0,1,72,12,60
8448,1,1,2,1,0,1,42,6,36
8449,9,5,3,1,1,2,90,21,69
8450,5,4,3,2,3,2,60,19,41
8458,288,238,167,121,60,60,3264,934,2330
8460,11,6,6,2,1,2,102,28,74
8461,7,6,2,3,1,1,72,20,52
0,0,0,0,0,0,0,0,0,0
0,0,0,0,0,0,0,0,0,0
0,0,0,0,0,0,0,0,0,0
0,0,0,0,0,0,0,0,0,0
0,0,0,0,0,0,0,0,0,0
0,0,0,0,0,0,0,0,0,0
8475,3,4,4,4,1,2,54,18,36
8476,9,6,2,1,2,3,78,23,55
8477,6,5,3,3,1,0,60,18,42
8481,5,4,2,1,1,0,48,13,35
8484,15,13,8,7,8,5,174,56,118
8485,12,12,8,4,3,3,126,42,84
8486,7,4,3,3,4,0,78,21,57
8490,7,6,5,3,4,1,90,26,64
8494,282,267,221,179,112,71,4200,1132,3068
8498,6,5,6,5,5,3,84,30,54
8499,10,9,8,4,5,2,138,38,100
8500,326,258,194,120,82,43,3816,1023,2793
8502,359,259,162,120,62,47,4188,1009,3179
8515,14,9,8,4,0,1,132,36,96
8528,252,234,211,147,123,26,3264,993,2271
8531,3,3,2,2,1,0,48,11,37
8532,8,10,8,8,7,3,132,44,88
8533,214,178,117,77,46,34,2580,666,1914
8535,7,5,4,4,2,1,72,23,49
8536,4,6,3,0,0,1,84,14,70
8539,275,231,161,109,60,45,2886,881,2005
8541,4,3,5,2,2,0,90,16,74
8542,9,6,4,3,1,1,72,24,48
8544,6,5,3,0,1,0,72,15,57
8552,8,5,3,2,2,0,90,20,70
8554,131,99,71,45,33,20,1992,399,1593
8556,3,4,2,2,2,1,60,14,46
0,0,0,0,0,0,0,0,0,0
0,0,0,0,0,0,0,0,0,0
0,0,0,0,0,0,0,0,0,0
0,0,0,0,0,0,0,0,0,0
0,0,0,0,0,0,0,0,0,0
8570,235,181,160,87,63,8,2682,734,1948
8576,196,153,85,60,33,34,2316,561,1755
8578,101,91,85,47,37,18,1440,379,1061
8584,290,250,180,149,79,60,3654,1008,2646
8590,8,7,8,2,0,2,84,27,57
8591,6,3,1,2,1,2,36,15,21
8596,10,8,8,5,6,2,144,39,105
8599,139,132,101,92,66,26,2226,556,1670
8646,182,118,87,56,27,24,2088,494,1594
8650,6,4,2,1,2,1,84,16,68
8653,251,233,130,112,54,56,2802,836,1966
8656,8,6,2,3,1,0,72,20,52
8657,11,11,5,4,2,2,114,35,79
8658,88,71,41,26,27,8,984,261,723
8662,189,164,148,97,49,29,2340,676,1664
8669,2,3,3,2,0,1,66,11,55
8671,1,1,2,0,0,0,36,4,32
8672,4,5,3,3,0,1,66,16,50
8674,2,1,2,1,0,0,30,6,24
9074,196,154,113,68,62,35,2160,628,1532
0,0,0,0,0,0,0,0,0,0
0,0,0,0,0,0,0,0,0,0
0,0,0,0,0,0,0,0,0,0
0,0,0,0,0,0,0,0,0,0
0,0,0,0,0,0,0,0,0,0
0,0,0,0,0,0,0,0,0,0
8691,151,128,96,53,39,32,1734,499,1235
8694,4,2,1,0,1,2,36,10,26
8695,6,6,2,1,1,3,66,19,47
8703,333,266,218,153,102,49,4044,1121,2923
8705,8,6,4,3,2,1,66,24,42
8706,10,9,5,3,3,1,96,31,65
8707,106,109,84,58,34,18,1620,409,1211
8710,9,9,6,3,3,2,138,32,106
8715,58,49,29,15,12,6,660,169,491
8720,11,8,6,5,4,2,138,36,102
8721,122,92,63,35,43,11,1542,366,1176
8724,7,3,2,2,3,1,90,18,72
0,0,0,0,0,0,0,0,0,0
0,0,0,0,0,0,0,0,0,0
0,0,0,0,0,0,0,0,0,0
0,0,0,0,0,0,0,0,0,0
0,0,0,0,0,0,0,0,0,0
0,0,0,0,0,0,0,0,0,0
8786,176,167,131,101,58,22,2406,655,1751
8790,31,25,22,12,6,7,438,103,335
8792,5,6,2,1,2,0,60,16,44
8794,12,9,9,8,6,1,120,45,75
8795,2,1,1,1,1,0,18,6,12
8797,46,45,29,22,4,13,660,159,501
8801,4,3,3,1,1,1,36,13,23
8803,10,11,11,6,4,4,126,46,80
8804,10,10,7,6,6,2,114,41,73
8805,10,10,7,6,6,2,114,41,73
8808,103,112,78,58,41,36,1266,428,838
0,0,0,0,0,0,0,0,0,0
0,0,0,0,0,0,0,0,0,0
0,0,0,0,0,0,0,0,0,0
0,0,0,0,0,0,0,0,0,0
0,0,0,0,0,0,0,0,0,0
0,0,0,0,0,0,0,0,0,0
8828,10,8,7,4,0,3,90,32,58
8829,14,17,11,4,1,3,180,50,130
8832,143,114,71,53,33,19,1650,433,1217
8835,9,10,6,3,3,3,90,34,56
8838,133,119,64,38,23,16,1452,393,1059
8840,1479,1328,1045,784,585,190,17952,5411,12541
8843,120,114,87,63,41,31,1746,456,1290
8848,1249,1097,771,623,433,190,14430,4363,10067
8850,182,136,102,75,42,34,1830,571,1259
8852,1326,1207,918,758,527,176,15780,4912,10868
8857,1206,995,800,565,343,192,14610,4101,10509
8863,1096,879,771,575,386,163,14148,3870,10278
8880,4,5,4,1,0,1,60,15,45
8882,13,9,9,6,1,0,138,38,100
8883,14,9,8,8,5,0,150,44,106
8887,6,4,2,1,1,0,72,14,58
8891,1078,951,807,660,379,142,15210,4017,11193
8893,91,71,56,36,25,15,1116,294,822
8897,2,2,2,1,1,0,24,8,16
8901,1239,1098,843,658,400,213,15222,4451,10771
8905,923,695,482,314,176,120,9630,2710,6920
8907,186,160,119,90,44,33,2292,632,1660
8909,389,350,264,168,108,66,5070,1345,3725
8912,11,11,5,7,4,4,114,42,72
8913,9,8,5,3,3,0,108,28,80
8914,11,10,5,4,4,1,138,35,103
8922,920,685,537,377,251,140,10326,2910,7416
8926,1268,1088,768,601,368,207,15240,4300,10940
8928,884,772,480,393,264,172,10500,2965,7535
8930,1311,1188,991,751,548,262,17952,5051,12901
8932,1274,969,701,490,306,194,14022,3934,10088
8942,11,7,5,2,1,0,96,26,70
8945,8,8,2,5,3,1,102,27,75
8948,12,9,7,5,5,3,102,41,61
8949,719,573,401,275,163,115,7434,2246,5188
8951,4,3,0,2,0,1,66,10,56
8952,6,5,4,2,1,2,84,20,64
8955,107,99,69,53,39,22,1410,389,1021
9057,99,90,57,48,36,23,1164,353,811
9059,1464,1362,837,686,466,225,16758,5040,11718
9061,13,8,5,2,3,1,138,32,106
9062,11,9,9,6,3,0,84,38,46
9065,18,16,15,14,6,7,198,76,122
9067,93,77,73,64,44,12,1356,363,993
9069,1147,1038,711,519,355,184,13752,3954,9798
9072,4,2,3,4,1,0,42,14,28
9078,2659,2107,1535,1027,656,464,29076,8448,20628
9080,150,160,127,87,60,27,2292,611,1681
9085,3,3,2,2,2,1,60,13,47
9086,3,3,2,2,2,1,60,13,47
9087,1134,1045,732,584,334,213,12624,4042,8582
9089,151,128,80,72,46,18,1722,495,1227
9093,1723,1492,1035,762,518,285,19326,5815,13511
9095,122,99,59,56,27,33,1428,396,1032
9099,1250,1087,774,589,356,231,13758,4287,9471
9101,1468,1320,902,669,491,242,17700,5092,12608
9103,167,156,114,85,41,24,2064,587,1477
9105,929,786,589,474,288,172,11166,3238,7928
9107,1421,1229,910,629,439,226,17028,4854,12174
9109,1507,1255,919,657,407,237,16152,4982,11170
9111,1664,1398,1002,803,497,298,19800,5662,14138
9113,1,1,0,0,0,0,12,2,10
9116,255,243,185,144,111,43,2952,981,1971
9120,116,102,92,55,42,20,1524,427,1097
9122,270,214,141,91,49,37,2736,802,1934
9124,18,16,10,5,2,4,186,55,131
9126,18,15,9,7,4,1,168,54,114
9128,12,10,7,3,3,0,126,35,91
9130,16,15,10,4,0,2,138,47,91
9407,254,212,168,97,79,38,2748,848,1900
9409,13,10,9,5,4,3,120,44,76
9411,10,13,6,3,3,0,126,35,91
9414,10,11,6,6,5,2,90,40,50
9422,54,53,42,34,27,4,792,214,578
9429,114,97,75,61,41,39,1656,427,1229
9431,1102,894,755,582,374,162,13266,3869,9397
9434,36,37,20,13,8,7,462,121,341
9436,1510,1334,965,747,502,253,17448,5311,12137
0,0,0,0,0,0,0,0,0,0
0,0,0,0,0,0,0,0,0,0
0,0,0,0,0,0,0,0,0,0
9450,1463,1213,850,649,428,217,16332,4820,11512
9452,257,223,172,115,84,42,3198,893,2305
9457,1428,1308,1123,855,566,333,17820,5613,12207
9461,1238,1090,857,640,441,226,15606,4492,11114
9465,6,9,4,3,2,2,108,26,82
9467,5,5,4,4,1,3,54,22,32
9469,136,126,108,75,53,35,1818,533,1285
9471,1619,1372,978,736,475,265,18666,5445,13221
9473,1790,1629,1240,1064,678,265,23772,6666,17106
9477,1661,1395,1003,802,497,297,19788,5655,14133
9479,231,185,136,91,57,31,2418,731,1687
9481,3,1,0,0,1,1,24,6,18
9482,10,8,10,6,2,1,138,37,101
9505,1389,1178,1021,768,505,218,17028,5079,11949
9507,53,47,31,10,5,9,570,155,415
9509,13,9,8,4,3,3,126,40,86
9510,1228,1075,840,677,407,178,15846,4405,11441
9516,9,7,4,4,3,0,90,27,63
9517,9,11,6,5,2,1,108,34,74
9518,210,177,120,105,66,36,2610,714,1896
9520,4,3,1,1,1,0,48,10,38
9526,1483,1256,899,691,482,202,17088,5013,12075
9528,201,178,170,127,102,38,3012,816,2196
9530,11,4,4,3,3,1,108,26,82
9532,1650,1353,917,637,457,229,18288,5243,13045
9534,49,46,35,25,21,10,612,186,426
9538,2180,1796,1263,865,574,370,22866,7048,15818
9542,5,5,3,2,2,0,72,17,55
0,0,0,0,0,0,0,0,0,0
0,0,0,0,0,0,0,0,0,0
0,0,0,0,0,0,0,0,0,0
0,0,0,0,0,0,0,0,0,0
0,0,0,0,0,0,0,0,0,0
0,0,0,0,0,0,0,0,0,0
0,0,0,0,0,0,0,0,0,0
9561,1571,1287,916,666,437,222,17790,5099,12691
9563,1602,1276,937,698,529,202,17340,5244,12096
9565,173,137,101,67,45,27,1758,550,1208
9568,7,8,2,4,1,4,84,26,58
9571,11,10,6,2,3,2,108,34,74
9576,1537,1266,940,695,463,232,18846,5133,13713
9588,2074,1697,1247,851,577,321,23004,6767,16237
9590,1300,1012,855,625,402,170,15240,4364,10876
9592,48,44,39,29,19,9,960,188,772
9594,1522,1316,1042,699,476,213,18984,5268,13716
9597,11,7,7,4,3,2,126,34,92
9599,13,11,9,9,5,2,168,49,119
9600,4,6,3,3,0,2,66,18,48
9601,6,5,4,2,2,1,78,20,58
9604,1960,1613,1232,957,553,342,22572,6657,15915
9606,2193,1659,1087,794,478,298,22278,6509,15769
9608,1745,1447,968,664,461,211,19032,5496,13536
9611,80,63,39,27,18,17,936,244,692
9613,1779,1591,1111,884,617,288,20766,6270,14496
9615,2214,1755,1162,789,531,283,22926,6734,16192
9618,1638,1431,943,667,454,290,18738,5423,13315
9620,261,201,147,109,62,46,3030,826,2204
9623,259,235,193,155,120,40,3210,1002,2208
9628,151,118,100,70,54,23,2022,516,1506
9633,12,10,5,6,3,1,138,37,101
9637,242,241,177,126,83,69,3108,938,2170
9639,11,14,6,4,3,1,108,39,69
9641,6,5,3,3,2,0,54,19,35
9642,10,6,7,3,4,2,78,32,46
9644,5,4,3,2,0,3,102,17,85
9646,5,5,3,2,2,0,78,17,61
9647,1921,1615,1188,825,499,307,22428,6355,16073
9650,1822,1586,1093,908,467,304,20880,6180,14700
9652,428,362,242,157,93,60,4104,1342,2762
9654,2191,1767,1236,806,507,300,23052,6807,16245
9657,16,13,8,6,4,3,174,50,124
9658,1107,923,698,490,341,160,13722,3719,10003
9660,1264,1137,801,682,442,194,15528,4520,11008
9662,1145,966,776,558,370,183,14442,3998,10444
0,0,0,0,0,0,0,0,0,0
9713,73,46,31,26,15,15,894,206,688
9715,1721,1473,1110,861,603,286,20976,6054,14922
9719,1583,1350,944,730,499,240,18330,5346,12984
9721,1305,1167,867,668,465,252,16104,4724,11380
9725,467,448,320,209,143,100,5538,1687,3851
9726,187,189,135,91,73,55,2472,730,1742
9729,4,3,3,2,2,0,42,14,28
9730,11,13,8,6,6,2,156,46,110
9731,7,8,2,2,2,1,66,22,44
9733,6,6,5,1,3,2,96,23,73
9734,230,199,122,89,60,36,2982,736,2246
9738,11,9,3,4,2,0,84,29,55
9743,11,7,4,3,1,2,114,28,86
9744,11,7,4,3,1,2,114,28,86
9752,110,90,55,34,23,12,1176,324,852
9757,9,7,7,5,2,1,120,31,89
9758,126,93,78,60,34,22,1506,413,1093
9761,1357,1063,804,596,358,165,16392,4343,12049
9763,1973,1389,988,734,432,235,20958,5751,15207
9765,809,564,398,293,185,107,9234,2356,6878
9767,168,134,105,68,47,36,1896,558,1338
9773,1649,1255,876,620,357,231,17718,4988,12730
9775,1370,925,607,438,252,142,14118,3734,10384
9848,199,174,127,90,52,36,2568,678,1890
9852,183,164,136,97,58,24,2466,662,1804
9855,9,6,3,2,1,0,96,21,75
9856,11,8,6,2,2,0,120,29,91
9859,5,1,2,2,0,2,54,12,42
9866,417,313,234,121,70,46,4266,1201,3065
9868,1314,1054,774,510,320,247,15264,4219,11045
9870,1660,1251,882,626,385,259,18348,5063,13285
9872,1390,1124,885,709,413,242,15660,4763,10897
9874,998,837,662,457,315,193,12486,3462,9024
9876,1864,1484,1067,748,445,273,20838,5881,14957
9878,1792,1388,929,655,417,321,19602,5502,14100
9880,1374,1150,855,622,395,221,14898,4617,10281
9882,1526,1346,955,746,495,287,19140,5355,13785
9884,1874,1624,1011,716,429,383,19422,6037,13385
9886,1752,1505,1121,811,529,291,19518,6009,13509
9888,1252,1003,739,531,323,212,13638,4060,9578
9890,1680,1450,991,669,424,279,18948,5493,13455
9892,243,243,207,164,118,51,3900,1026,2874
9894,4,6,3,1,1,1,54,16,38
9895,6,9,5,4,3,2,66,29,37
9899,122,101,73,58,43,36,1416,433,983
9904,10,6,5,2,0,1,120,24,96
9908,364,331,271,172,105,60,5532,1303,4229
9911,11,11,8,6,3,1,144,40,104
9912,8,3,3,0,0,1,66,15,51
9913,8,7,6,2,0,0,108,23,85
9920,7,8,4,3,3,1,78,26,52
9921,126,96,66,37,24,23,1320,372,948
9929,12,9,7,3,1,0,126,32,94
9946,121,103,70,58,34,24,1332,410,922
9950,463,362,258,190,103,67,5634,1443,4191
9953,10,8,6,6,2,4,102,36,66
9955,14,20,9,5,2,3,138,53,85
9956,14,20,9,5,2,3,138,53,85
9958,10,7,7,5,2,2,96,33,63
9959,10,9,5,3,1,1,96,29,67
9960,6,7,6,6,3,3,108,31,77
9961,2,4,2,2,2,1,36,13,23
9965,1563,1371,1048,750,507,287,18396,5526,12870
9967,1638,1425,991,720,542,259,19410,5575,13835
9969,1441,1139,807,602,414,215,16692,4618,12074
9971,1217,1022,744,516,323,165,13620,3987,9633
9974,0,1,0,1,0,0,18,2,16
9975,176,161,97,80,67,35,1956,616,1340
9978,1467,1144,770,530,359,219,16578,4489,12089
9980,323,279,211,146,73,51,3690,1083,2607
9982,528,443,296,238,123,89,5676,1717,3959
9984,1864,1463,965,708,427,246,19440,5673,13767
9988,1527,1172,789,557,345,218,17040,4608,12432
9990,1825,1554,1120,817,551,302,20718,6169,14549
9992,1307,983,720,535,367,205,15276,4117,11159
9994,209,160,109,66,35,33,2472,612,1860
10001,6,7,5,5,3,2,90,28,62
10003,106,93,75,54,40,19,1392,387,1005
10007,107,95,80,54,39,19,1506,394,1112
10009,249,235,180,132,69,57,3294,922,2372
10011,2,2,2,1,0,1,36,8,28
10015,243,198,88,64,51,37,2304,681,1623
10027,125,98,77,39,24,14,1398,377,1021
10030,1158,939,759,506,326,195,14610,3883,10727
10032,1525,1407,951,749,429,314,17910,5375,12535
10034,1986,1691,1247,900,614,315,23004,6753,16251
10036,299,235,164,114,79,32,3150,923,2227
10039,12,12,8,8,6,3,132,49,83
10050,1177,957,723,517,355,186,13548,3915,9633
10052,1971,1568,1081,739,443,269,20904,6071,14833
10055,74,66,55,42,27,13,1068,277,791
10058,6,4,0,1,1,1,66,13,53
10061,2220,1941,1414,1064,735,410,25674,7784,17890
10063,2487,2137,1529,1088,668,454,27786,8363,19423
10065,1108,1038,841,663,442,188,13842,4280,9562
10067,1511,1107,785,528,330,161,17136,4422,12714
10069,1257,1059,750,506,296,173,13206,4041,9165
10071,1571,1370,955,729,480,302,19434,5407,14027
10128,217,196,138,82,56,42,2400,731,1669
10148,167,140,102,70,38,23,1926,540,1386
10155,323,291,202,128,99,68,3744,1111,2633
10157,7,9,8,6,3,0,120,33,87
10160,7,6,2,1,2,2,66,20,46
10168,585,500,291,241,115,78,5736,1810,3926
10171,6,6,2,2,2,0,42,18,24
10173,153,116,98,63,25,24,1788,479,1309
10180,45,46,34,32,17,10,576,184,392
10182,300,269,171,117,80,51,4086,988,3098
10186,5,4,2,1,0,1,60,13,47
10191,2,1,1,1,0,2,24,7,17
10193,6,5,3,4,1,1,60,20,40
10194,2,5,3,2,1,2,60,15,45
10197,3,4,2,3,1,0,48,13,35
10198,167,129,90,70,37,20,1692,513,1179
10200,295,232,154,108,63,57,3036,909,2127
10204,86,93,51,38,26,14,1062,308,754
10206,1628,1359,1051,827,546,207,18510,5618,12892
10208,3,2,2,1,0,0,36,8,28
10209,6,1,1,1,0,0,42,9,33
10211,16,14,10,8,4,3,138,55,83
10212,6,6,3,3,2,1,72,21,51
10213,202,165,124,95,46,24,2514,656,1858
10215,1630,1391,966,757,427,278,18120,5449,12671
10217,1602,1460,1058,800,533,297,19662,5750,13912
10219,1582,1298,912,636,391,305,18552,5124,13428
10221,2155,1803,1446,1132,815,307,24558,7658,16900
10223,109,105,85,55,39,22,1428,415,1013
10225,47,40,30,18,10,8,738,153,585
10227,246,213,163,121,91,39,3234,873,2361
10232,2,6,4,1,3,3,60,19,41
10234,10,12,8,7,6,1,96,44,52
10238,12,14,9,7,5,1,150,48,102
10241,48,36,23,13,14,7,504,141,363
10243,209,168,125,99,72,35,2388,708,1680
10245,179,157,92,61,53,14,2538,556,1982
10267,5,4,2,2,2,1,84,16,68
10276,5,7,4,4,2,3,90,25,65
10283,488,405,282,212,137,73,5436,1597,3839
10291,38,31,23,13,9,6,384,120,264
10293,1242,1018,788,570,355,186,14580,4159,10421
10295,2338,1739,1205,910,561,311,26334,7064,19270
10297,1588,1388,1033,808,507,240,18594,5564,13030
10300,145,95,72,71,22,23,1464,428,1036
10304,1614,1334,921,637,377,221,17568,5104,12464
10307,1630,1385,983,613,333,222,18072,5166,12906
10311,1238,1082,839,594,393,228,15048,4374,10674
10316,1279,1009,756,504,356,182,15702,4086,11616
10318,2175,1834,1320,989,705,380,26388,7403,18985
10320,1270,1143,856,694,415,224,15288,4602,10686
10325,10,11,6,6,2,3,114,38,76
10332,11,11,5,2,2,2,108,33,75
10333,104,76,53,47,33,31,1182,344,838
10335,213,207,172,118,82,27,2478,819,1659
0,0,0,0,0,0,0,0,0,0
10353,231,200,149,115,70,45,2478,810,1668
10355,3,3,2,2,1,2,48,13,35
10356,197,161,124,68,48,30,2490,628,1862
10360,9,8,8,6,2,2,102,35,67
0,0,0,0,0,0,0,0,0,0
10366,138,105,66,38,20,24,1650,391,1259
10376,253,236,166,110,71,44,2946,880,2066
10380,15,10,11,6,3,7,150,52,98
10384,69,65,42,30,28,6,894,240,654
10386,1151,958,732,567,404,165,14922,3977,10945
10388,1428,1168,910,689,423,206,15636,4824,10812
10390,1573,1243,912,672,397,174,16722,4971,11751
10395,141,91,67,53,26,17,1638,395,1243
10412,1355,1121,846,636,432,159,16260,4549,11711
10414,1197,1075,834,685,495,182,15120,4468,10652
10416,1569,1355,1042,782,506,226,18834,5480,13354
10418,1436,1220,808,606,368,260,16998,4698,12300
10425,6,5,4,3,2,0,90,20,70
10427,6,7,4,3,2,1,96,23,73
10432,347,309,206,148,101,60,4182,1171,3011
10434,74,67,43,35,23,20,804,262,542
10436,116,96,73,54,30,27,1290,396,894
10438,83,69,42,33,21,18,990,266,724
10443,10,5,5,4,2,1,96,27,69
10445,4,3,3,2,1,1,42,14,28
10449,98,93,69,45,29,23,1488,357,1131
10451,254,222,146,82,78,58,2868,840,2028
10453,46,40,25,17,12,4,672,144,528
10468,200,165,108,86,49,32,2322,640,1682
11314,149,141,101,85,61,19,1956,556,1400
10483,140,127,86,69,39,19,1806,480,1326
10486,17,14,7,4,3,2,138,47,91
10487,20,16,6,5,5,2,162,54,108
10488,323,272,185,106,79,66,3810,1031,2779
10495,1422,1332,1063,774,464,290,15870,5345,10525
10497,1303,1238,923,726,412,238,16122,4840,11282
10499,1462,1155,860,681,410,210,16554,4778,11776
10501,1568,1323,993,684,479,272,17460,5319,12141
10503,1731,1490,1075,752,521,241,19020,5810,13210
10505,1116,967,737,558,407,201,14262,3986,10276
10507,1592,1317,952,750,447,283,19098,5341,13757
10509,1740,1533,1103,855,573,284,20124,6088,14036
10511,261,234,147,113,64,46,2772,865,1907
10516,8,5,3,2,2,0,54,20,34
10530,67,70,54,38,24,13,900,266,634
10531,76,70,63,49,29,17,1122,304,818
10538,16,14,12,7,3,4,276,56,220
10549,9,9,6,6,7,2,114,39,75
10550,145,133,100,71,61,24,1782,534,1248
10554,157,123,82,65,43,23,1926,493,1433
10556,3,4,3,4,2,1,36,17,19
10558,6,6,4,4,1,1,72,22,50
10560,98,69,52,23,20,15,1164,277,887
10575,260,250,218,163,125,38,3696,1054,2642
10577,7,6,3,3,2,1,60,22,38
10579,5,8,3,1,1,2,66,20,46
10580,8,6,6,7,1,1,108,29,79
10581,116,98,71,59,25,19,1596,388,1208
10583,988,841,650,415,289,155,12186,3338,8848
10585,1696,1375,1030,756,458,216,19242,5531,13711
10590,1802,1391,968,595,359,236,18888,5351,13537
10593,1984,1495,1056,687,426,319,22104,5967,16137
10595,1422,1101,783,545,363,210,16170,4424,11746
10597,1611,1363,1023,698,521,274,18996,5490,13506
10599,1382,1159,859,579,431,197,15732,4607,11125
10601,1793,1632,1239,1066,678,268,23736,6676,17060
10603,136,155,98,79,49,40,1608,557,1051
10606,170,142,110,83,45,19,1716,569,1147
10616,52,49,32,24,12,11,756,180,576
10618,2,1,0,0,0,0,30,3,27
10620,143,117,84,61,42,20,1590,467,1123
10623,8,6,6,4,1,1,84,26,58
10624,10,6,7,4,2,1,96,30,66
10626,246,225,167,121,78,43,2532,880,1652
10630,9,9,6,6,4,0,72,34,38
10699,1287,1039,897,646,402,147,15102,4418,10684
10634,5,4,4,1,0,2,60,16,44
10697,197,156,101,58,60,22,2976,594,2382
10701,1540,1233,897,669,425,217,17640,4981,12659
10703,1044,767,525,393,271,111,11490,3111,8379
10705,1968,1463,1024,709,429,266,21804,5859,15945
10707,1872,1500,1195,825,546,314,21384,6252,15132
10709,1173,901,686,466,257,169,13332,3652,9680
10711,1440,1205,925,686,420,275,16920,4951,11969
10714,854,723,577,418,297,131,10938,3000,7938
10716,935,815,622,496,277,178,12138,3323,8815
10718,1515,1296,911,695,461,212,16056,5090,10966
10720,1211,1069,837,603,426,238,14202,4384,9818
10722,1346,1285,1004,737,431,265,16182,5068,11114
10724,1260,1178,841,660,421,225,15402,4585,10817
10726,66,49,32,24,10,13,804,194,610
10815,292,289,212,164,104,60,4140,1121,3019
10844,82,72,62,55,25,15,900,311,589
10864,339,309,228,180,137,80,3582,1273,2309
10866,4,4,4,3,1,1,54,17,37
0,0,0,0,0,0,0,0,0,0
0,0,0,0,0,0,0,0,0,0
10875,126,91,57,42,36,16,1518,368,1150
10881,141,142,119,96,42,42,2028,582,1446
10895,188,148,128,89,30,19,2022,602,1420
10899,3,1,1,1,0,0,24,6,18
10900,3,3,1,1,1,0,30,9,21
10911,68,55,40,30,14,11,1134,218,916
10913,10,8,8,5,4,1,96,36,60
10914,2,1,1,1,0,1,48,6,42
10916,2,1,0,0,0,1,42,4,38
10952,1724,1386,1099,854,502,290,19728,5855,13873
10954,1584,1295,909,622,457,202,18306,5069,13237
10956,1631,1471,1036,773,458,274,18762,5643,13119
10958,1135,918,660,499,329,173,12594,3714,8880
10960,1158,1028,841,627,407,194,13980,4255,9725
10962,184,129,103,89,38,29,1884,572,1312
10964,934,881,733,543,342,175,13710,3608,10102
10966,1269,1100,802,595,313,163,15744,4242,11502
10974,139,128,98,71,30,22,1674,488,1186
10976,7,7,6,5,3,2,102,30,72
10977,6,7,4,2,2,0,90,21,69
10986,169,157,109,76,51,34,2028,596,1432
10989,3,3,4,1,0,0,54,11,43
0,0,0,0,0,0,0,0,0,0
11012,150,130,100,77,32,29,1740,518,1222
11023,5,3,2,1,1,1,48,13,35
11024,7,8,6,4,1,3,78,29,49
11029,87,58,41,28,17,13,930,244,686
11031,24,16,8,7,2,3,186,60,126
11034,429,338,251,181,107,56,4674,1362,3312
11036,3,3,2,2,1,0,36,11,25
11037,10,5,6,6,3,1,78,31,47
11038,7,8,5,5,3,0,108,28,80
11041,104,73,60,45,28,24,1002,334,668
11043,247,196,143,123,43,38,3030,790,2240
11050,136,116,68,31,27,13,1470,391,1079
11052,16,14,5,4,2,1,138,42,96
11053,8,7,4,1,0,1,66,21,45
11063,250,239,186,110,62,49,2568,896,1672
11066,14,13,12,9,4,3,132,55,77
11072,17,19,17,11,6,5,168,75,93
11074,13,10,8,5,1,2,114,39,75
11075,69,68,54,38,29,17,846,275,571
11077,1703,1410,1041,777,474,250,19974,5655,14319
11079,1442,1110,789,591,351,226,17796,4509,13287
11081,1521,1295,935,749,499,249,17100,5248,11852
11084,1185,1011,795,594,327,206,13764,4118,9646
11086,1397,1087,836,597,360,231,16908,4508,12400
11088,1437,1201,859,670,405,215,16860,4787,12073
11090,1464,1286,885,646,388,251,16218,4920,11298
11092,250,253,170,121,84,56,2790,934,1856
11094,2196,1878,1352,1134,715,386,24606,7661,16945
11096,1980,1627,1206,866,500,295,20748,6474,14274
11098,1478,1327,1018,794,509,267,18138,5393,12745
11100,1743,1476,1085,803,444,263,19482,5814,13668
14681,7,7,5,4,2,1,72,26,46
11106,183,149,94,67,29,31,2166,553,1613
11113,144,109,92,67,49,24,1506,485,1021
11128,100,114,74,51,44,23,1134,406,728
11133,18,14,9,5,0,4,120,50,70
11134,5,5,4,3,2,1,84,20,64
11169,57,39,29,20,6,3,774,154,620
11172,3,2,3,1,0,0,42,9,33
11174,307,287,173,122,93,45,2976,1027,1949
11177,245,229,157,139,60,73,3336,903,2433
11179,132,103,67,48,30,27,1458,407,1051
11182,4,5,4,4,2,5,42,24,18
11184,646,543,406,318,208,94,7740,2215,5525
11186,1885,1714,1022,797,550,234,21294,6202,15092
11188,2584,2200,1482,1061,632,443,28584,8402,20182
11190,0,0,0,0,0,0,0,0,0
11193,16,15,8,4,5,3,156,51,105
11194,9,12,10,7,5,1,132,44,88
11195,14,12,5,4,3,3,132,41,91
11197,7,8,4,4,1,0,66,24,42
11212,22,20,18,16,6,6,384,88,296
11214,136,138,103,101,46,25,2106,549,1557
11217,231,197,153,125,86,42,3078,834,2244
12882,38,26,22,15,10,7,498,118,380
11397,73,58,29,22,13,13,786,208,578
11223,367,315,240,160,106,61,3972,1249,2723
11225,87,78,47,33,25,13,834,283,551
11227,141,93,75,46,27,18,1554,400,1154
11262,40,27,23,14,8,4,474,116,358
11242,158,150,120,84,65,38,1968,615,1353
11251,188,155,111,70,38,34,2322,596,1726
11253,218,194,160,101,75,47,2718,795,1923
11264,3,3,2,1,1,0,24,10,14
11267,917,817,632,444,310,145,11310,3265,8045
11269,829,774,612,463,307,153,10590,3138,7452
11271,1444,1286,1020,719,454,286,18828,5209,13619
11273,2053,1702,1340,1002,606,332,23694,7035,16659
11275,1094,933,743,559,379,172,13644,3880,9764
11293,156,136,101,71,34,26,1746,524,1222
11295,11,13,7,6,3,2,108,42,66
11296,10,8,7,5,3,4,120,37,83
11298,9,9,5,3,2,2,78,30,48
11320,2060,1770,1154,784,495,322,21432,6585,14847
11322,1690,1409,1069,851,524,264,19128,5807,13321
11324,1562,1506,1196,865,541,259,19530,5929,13601
11326,1390,1301,949,677,479,253,17226,5049,12177
11329,59,51,35,22,9,12,690,188,502
11333,208,182,134,95,54,33,2658,706,1952
11335,4,4,3,4,1,0,72,16,56
11336,2,2,3,1,0,0,36,8,28
11339,5,5,4,3,2,0,54,19,35
11340,5,5,1,1,1,1,48,14,34
11341,4,4,1,3,3,1,42,16,26
11350,67,68,58,37,17,18,1008,265,743
11353,230,159,99,75,29,25,2526,617,1909
11355,4,5,3,2,0,0,60,14,46
0,0,0,0,0,0,0,0,0,0
11370,139,132,102,80,47,20,2064,520,1544
11373,211,180,100,77,63,38,2628,669,1959
11375,3,3,0,0,0,1,42,7,35
11391,68,47,55,34,30,0,822,234,588
11411,11,12,6,5,3,5,114,42,72
11412,11,12,6,5,3,5,114,42,72
11418,400,315,223,145,80,60,4218,1223,2995
11427,23,18,13,5,5,3,300,67,233
11432,250,209,165,125,60,52,2712,861,1851
11434,6,3,0,2,2,1,54,14,40
11435,14,10,11,6,3,5,144,49,95
11436,14,10,11,6,3,5,144,49,95
11438,7,9,5,5,1,1,72,28,44
11443,1272,956,653,472,360,175,14334,3888,10446
11445,325,260,184,141,65,60,4314,1035,3279
11447,1379,1078,761,550,294,185,15510,4247,11263
11449,1216,1010,804,569,374,225,13902,4198,9704
11459,987,746,571,424,243,156,11712,3127,8585
11461,1735,1469,1004,754,438,292,20838,5692,15146
11463,1470,1277,1010,765,548,211,17802,5281,12521
11465,144,139,99,69,31,26,2034,508,1526
11467,1404,1105,823,628,344,247,15648,4551,11097
11469,1886,1453,1008,740,505,278,20646,5870,14776
11471,1009,914,684,545,382,150,12852,3684,9168
11473,1719,1385,1023,695,460,260,19392,5542,13850
11475,2161,1721,1148,797,494,350,22818,6671,16147
11482,91,73,52,37,25,12,1014,290,724
11485,7,5,4,1,0,2,72,19,53
11510,29,28,29,25,15,3,426,129,297
11516,4,4,1,1,1,0,30,11,19
11517,5,5,2,0,2,2,48,16,32
11518,3,3,0,0,0,0,30,6,24
11519,3,3,3,2,3,2,48,16,32
11522,198,169,115,79,50,31,2610,642,1968
11524,14,13,5,3,3,2,144,40,104
11525,14,13,5,3,3,2,144,40,104
11526,9,11,7,2,5,2,144,36,108
11541,355,298,210,155,101,59,3990,1178,2812
11565,169,132,105,74,30,27,1836,537,1299
11572,7,7,4,4,0,2,66,24,42
11573,4,2,1,2,0,0,30,9,21
11578,50,34,24,23,8,3,762,142,620
11582,5,4,3,3,2,0,42,17,25
11587,1554,1208,959,688,466,261,17136,5136,12000
11589,1423,1005,662,411,284,190,14832,3975,10857
11591,1065,810,658,499,282,144,13578,3458,10120
11593,1527,1307,1014,773,528,264,17580,5413,12167
11596,1249,1124,848,690,425,174,15504,4510,10994
11598,1570,1329,958,733,475,260,17166,5325,11841
11600,1634,1347,949,676,428,264,18636,5298,13338
11602,2844,2123,1454,1039,665,352,31242,8477,22765
11604,222,151,117,63,29,28,2586,610,1976
11607,6,5,3,2,0,0,60,16,44
11608,70,60,57,42,26,15,834,270,564
11625,280,221,179,138,75,42,3660,935,2725
11636,7,6,3,3,1,1,66,21,45
11648,410,328,241,189,132,77,5262,1377,3885
11653,2,2,1,3,1,1,36,10,26
11655,225,189,148,107,86,42,2478,797,1681
11658,144,138,117,77,62,29,2250,567,1683
11663,8,5,3,2,0,0,66,18,48
11665,326,293,204,172,102,64,3864,1161,2703
11679,12,10,8,3,2,3,126,38,88
11680,4,4,3,1,1,0,48,13,35
11681,3,5,1,3,0,1,78,13,65
11688,9,9,9,9,6,1,120,43,77
11689,13,11,5,6,3,2,120,40,80
11694,121,120,87,83,58,31,1686,500,1186
11702,1212,1056,789,570,415,217,14040,4259,9781
11704,1490,1289,893,732,419,226,17538,5049,12489
11706,1591,1361,1008,747,487,240,18264,5434,12830
11708,1953,1697,1190,933,596,317,22920,6686,16234
11710,1045,939,668,528,331,187,12792,3698,9094
11712,1194,1005,730,534,366,179,13578,4008,9570
11714,1559,1316,942,679,448,283,18606,5227,13379
11716,1535,1307,1043,748,470,264,19272,5367,13905
13693,206,175,141,83,71,37,2406,713,1693
11721,211,174,117,116,69,40,2760,727,2033
11723,135,113,71,50,19,22,1698,410,1288
11730,286,189,155,123,66,58,3156,877,2279
11737,9,10,7,6,2,2,90,36,54
11738,9,10,7,6,2,2,90,36,54
11740,5,5,4,3,3,0,48,20,28
11741,7,4,1,2,0,2,48,16,32
11774,106,88,64,50,29,22,1266,359,907
11777,9,9,4,5,3,1,102,31,71
11786,205,190,150,97,57,31,2418,730,1688
11788,279,249,182,138,64,55,3414,967,2447
11790,1212,897,649,453,282,130,14280,3623,10657
11792,279,214,140,92,40,42,3240,807,2433
11794,110,85,93,66,37,16,1422,407,1015
11798,8,8,6,6,3,1,78,32,46
11802,362,276,208,142,88,51,3564,1127,2437
11804,1042,822,575,382,249,111,11490,3181,8309
11806,1197,1029,795,665,467,199,14706,4352,10354
11809,896,785,664,529,374,165,12228,3413,8815
11811,1266,1080,771,567,326,211,14868,4221,10647
11813,1187,1024,739,532,385,214,13320,4081,9239
11815,889,808,636,480,297,156,11316,3266,8050
11817,1178,980,816,549,351,132,14622,4006,10616
11819,1400,1162,913,629,431,227,17934,4762,13172
11832,7,5,8,7,3,2,90,32,58
11833,8,8,10,8,4,3,120,41,79
11836,12,11,6,3,1,1,120,34,86
11837,201,191,160,116,93,21,2754,782,1972
11843,125,118,102,82,53,36,1902,516,1386
11849,104,80,58,30,23,14,1164,309,855
11865,224,169,105,74,54,30,2118,656,1462
11873,3,2,1,1,1,0,36,8,28
11874,210,171,107,81,44,45,2592,658,1934
11877,5,5,4,3,2,2,114,21,93
0,0,0,0,0,0,0,0,0,0
0,0,0,0,0,0,0,0,0,0
11888,241,189,150,90,51,32,2658,753,1905
0,0,0,0,0,0,0,0,0,0
11905,61,69,51,30,21,14,666,246,420
11907,851,657,524,379,239,105,10596,2755,7841
11909,1154,1032,817,631,443,179,14778,4256,10522
11913,1578,1212,864,651,375,229,17568,4909,12659
11917,11,5,8,6,1,0,102,31,71
11918,11,5,8,6,1,0,102,31,71
0,0,0,0,0,0,0,0,0,0
0,0,0,0,0,0,0,0,0,0
0,0,0,0,0,0,0,0,0,0
0,0,0,0,0,0,0,0,0,0
0,0,0,0,0,0,0,0,0,0
11982,291,256,176,125,76,73,3510,997,2513
0,0,0,0,0,0,0,0,0,0
11987,1395,1116,850,574,326,172,16584,4433,12151
11989,857,692,524,372,266,135,10170,2846,7324
11992,1023,830,673,456,313,124,13206,3419,9787
11994,1162,891,686,479,304,156,13218,3678,9540
12022,225,213,143,109,73,42,3000,805,2195
0,0,0,0,0,0,0,0,0,0
0,0,0,0,0,0,0,0,0,0
12054,11,7,3,1,2,3,102,27,75
12059,4,4,1,2,2,1,54,14,40
12066,49,41,39,24,18,5,618,176,442
12074,116,72,62,36,22,17,1308,325,983
12079,7,6,4,2,0,2,96,21,75
12081,12,10,7,5,1,4,144,39,105
12082,11,4,7,5,1,0,108,28,80
12125,169,163,112,81,51,41,2274,617,1657
12152,304,251,188,128,76,58,3300,1005,2295
12156,4,4,5,1,4,2,66,20,46
12158,8,5,5,3,1,0,90,22,68
12208,79,69,48,26,23,15,912,260,652
12241,173,143,102,63,35,30,2106,546,1560
12243,1125,894,675,541,316,193,14064,3744,10320
12245,2384,1933,1511,1068,631,355,25782,7882,17900
12247,1828,1638,1238,907,630,341,21558,6582,14976
12249,906,756,558,404,233,132,11160,2989,8171
12251,1832,1548,1169,853,565,243,20808,6210,14598
12253,1596,1393,1009,773,504,248,18690,5523,13167
12255,1179,1040,798,582,350,216,13416,4165,9251
12260,1435,1107,853,584,357,240,15894,4576,11318
12262,1837,1469,1030,765,499,231,19980,5831,14149
12267,8,4,6,2,1,0,90,21,69
12270,142,124,82,54,44,17,1734,463,1271
12272,190,195,122,107,79,34,2646,727,1919
12276,17,14,9,6,6,1,120,53,67
12278,9,10,5,5,4,1,126,34,92
12282,5,8,5,4,2,4,72,28,44
12283,7,7,5,6,4,1,96,30,66
12284,6,9,6,3,2,0,60,26,34
12285,6,9,6,3,2,0,60,26,34
12286,179,123,94,63,41,24,2028,524,1504
12310,207,200,149,84,58,41,2370,739,1631
0,0,0,0,0,0,0,0,0,0
12324,192,160,98,67,50,27,2250,594,1656
12326,68,56,41,37,25,12,738,239,499
12354,17,14,7,4,2,2,186,46,140
12364,8,7,6,3,3,3,90,30,60
12378,166,143,97,82,48,31,1860,567,1293
12383,183,174,130,91,67,38,1944,683,1261
12385,56,46,37,22,14,5,882,180,702
12392,1240,913,714,441,263,179,13794,3750,10044
12394,1336,1127,894,664,421,178,16272,4620,11652
12396,866,647,480,348,234,112,9552,2687,6865
12398,0,0,0,0,0,0,0,0,0
12400,1754,1400,1017,702,449,255,19458,5577,13881
12402,1738,1460,1141,840,562,225,19800,5966,13834
12407,12,14,7,4,2,1,138,40,98
12408,6,4,4,3,1,0,66,18,48
12409,11,9,5,4,2,2,108,33,75
12432,182,148,124,95,62,39,2100,650,1450
12437,245,210,129,106,71,45,2844,806,2038
12441,6,7,6,5,3,1,78,28,50
12461,261,214,168,114,78,46,3282,881,2401
12468,23,16,13,7,5,4,180,68,112
12469,8,8,6,4,2,1,72,29,43
12472,12,10,5,4,4,2,102,37,65
12473,98,85,61,41,30,17,1014,332,682
12855,98,84,67,46,27,22,1212,344,868
12491,94,73,59,48,21,11,1002,306,696
12501,4,4,3,3,3,0,48,17,31
12504,6,7,5,3,0,1,90,22,68
12505,8,8,7,5,3,2,102,33,69
12523,127,108,69,64,40,30,1740,438,1302
12525,1418,1168,874,625,370,267,15288,4722,10566
12527,907,766,580,412,340,144,10716,3149,7567
12529,1289,950,654,469,339,148,14070,3849,10221
12531,784,616,451,346,216,148,8868,2561,6307
12533,2729,2094,1446,1048,592,451,29640,8360,21280
12535,1047,832,647,461,294,163,11730,3444,8286
12537,1367,1143,793,568,378,168,14748,4417,10331
12539,1309,1147,883,615,407,268,14712,4629,10083
12541,141,115,75,60,38,31,1440,460,980
12545,10,9,3,6,2,3,90,33,57
12546,10,9,3,6,2,3,90,33,57
12552,2,3,0,2,1,0,42,8,34
12553,5,6,3,3,3,1,54,21,33
12556,12,8,10,6,2,2,108,40,68
0,0,0,0,0,0,0,0,0,0
12578,92,77,44,34,23,19,1038,289,749
12580,7,6,3,4,2,2,84,24,60
12598,56,40,20,17,9,12,870,154,716
12609,90,85,61,45,28,14,1374,323,1051
12627,113,110,83,59,38,34,1152,437,715
12631,8,7,4,2,1,1,72,23,49
12645,3069,2632,1887,1383,858,535,33240,10364,22876
12647,371,319,263,199,118,73,4488,1343,3145
12649,1837,1526,1186,864,508,319,20070,6240,13830
12653,912,816,683,565,366,154,12954,3496,9458
12655,1404,1208,908,640,434,251,17040,4845,12195
12657,1687,1395,984,766,483,291,18888,5606,13282
12659,1170,1032,740,547,373,187,13818,4049,9769
12661,1537,1400,1027,726,507,253,19080,5450,13630
12677,11,13,9,6,2,1,138,42,96
12679,315,319,238,176,110,53,4068,1211,2857
12684,12,8,6,5,2,3,120,36,84
12686,5,3,2,1,1,0,60,12,48
12691,12,12,2,5,1,2,132,34,98
12692,110,97,82,65,47,15,1896,416,1480
12696,184,150,102,74,48,27,2208,585,1623
12713,152,91,62,41,21,18,1602,385,1217
12729,84,69,49,39,21,18,1074,280,794
12731,12,10,5,4,1,1,114,33,81
12732,10,8,3,3,0,0,102,24,78
12734,4,2,1,1,1,0,42,9,33
12735,51,49,29,30,13,20,684,192,492
12988,196,136,82,54,31,17,2238,516,1722
12742,75,50,23,19,6,18,792,191,601
12744,261,244,190,112,110,49,3312,966,2346
12746,203,186,149,121,84,39,2700,782,1918
12748,11,9,11,8,5,4,144,48,96
12749,10,11,8,6,3,2,120,40,80
12750,10,11,8,6,3,2,120,40,80
12755,14,13,7,7,5,2,156,48,108
12757,12,11,13,7,4,7,126,54,72
12761,13,14,10,3,4,2,150,46,104
12764,7,6,4,2,3,2,60,24,36
12766,59,56,41,30,18,9,912,213,699
12769,315,280,168,126,96,53,4212,1038,3174
12771,1234,1081,860,628,433,229,16482,4465,12017
12775,1025,755,582,351,245,123,11028,3081,7947
12778,1454,1180,791,572,374,182,15612,4553,11059
12782,958,899,743,543,363,165,11586,3671,7915
12784,990,876,655,469,338,152,11694,3480,8214
12786,1363,1144,856,585,361,146,15654,4455,11199
12788,1908,1686,1246,930,579,291,20910,6640,14270
12790,1516,1353,951,720,487,231,18330,5258,13072
12792,1533,1371,1076,791,496,320,19710,5587,14123
12794,1296,1188,867,714,455,201,16266,4721,11545
12796,955,845,694,551,354,147,12498,3546,8952
12798,320,279,208,155,90,88,4098,1140,2958
12800,259,258,146,118,70,56,3000,907,2093
12802,240,217,140,110,64,45,2790,816,1974
12804,6,5,5,1,0,2,102,19,83
12806,6,10,5,4,2,2,132,29,103
12807,4,4,3,2,2,0,54,15,39
12858,182,165,146,101,60,50,2184,704,1480
12869,32,27,21,13,8,7,450,108,342
12871,9,6,7,5,2,2,96,31,65
12874,13,11,11,8,4,3,156,50,106
12880,45,38,29,17,8,7,564,144,420
12884,1259,1087,887,642,370,226,15228,4471,10757
12886,1124,893,713,513,283,178,12258,3704,8554
12888,1397,1150,906,608,444,197,15954,4702,11252
12892,1760,1504,1136,858,547,329,19782,6134,13648
12894,1249,1187,915,675,437,240,15318,4703,10615
12896,1195,1052,814,624,396,217,14934,4298,10636
12898,1622,1387,1078,758,462,296,18822,5603,13219
12900,1601,1453,1044,800,475,294,19596,5667,13929
12902,699,647,513,373,299,144,9558,2675,6883
12904,3,3,1,1,2,0,36,10,26
12905,156,144,139,107,91,39,2202,676,1526
12916,230,181,139,100,59,47,2436,756,1680
12918,65,58,60,32,23,11,924,249,675
12929,8,8,6,5,4,1,90,32,58
12930,1,1,1,1,1,0,36,5,31
12931,3,4,5,2,3,1,54,18,36
12937,4,3,4,1,1,0,48,13,35
12939,6,6,2,3,0,2,60,19,41
12941,12,10,5,5,3,2,132,37,95
12942,3,2,1,1,0,1,48,8,40
12944,107,97,70,47,44,14,1146,379,767
0,0,0,0,0,0,0,0,0,0
12969,118,90,69,53,31,31,1440,392,1048
12973,1103,883,628,391,209,158,11886,3372,8514
12975,1672,1258,950,677,376,330,18324,5263,13061
12977,776,672,496,379,240,136,9354,2699,6655
12979,1130,1061,765,623,435,181,13890,4195,9695
12981,1217,1065,856,536,418,162,14352,4254,10098
12992,5,6,3,1,1,0,60,16,44
12998,111,91,59,33,15,17,1284,326,958
0,0,0,0,0,0,0,0,0,0
13007,3,3,2,0,0,1,24,9,15
13008,10,9,6,4,2,1,96,32,64
13009,6,7,4,5,4,2,54,28,26
13011,94,68,30,21,40,6,906,259,647
13018,221,211,160,114,80,43,3186,829,2357
13020,197,147,103,71,41,25,2076,584,1492
13022,11,9,6,7,3,4,132,40,92
13024,118,109,88,72,44,20,1614,451,1163
13031,172,129,103,65,37,29,1788,535,1253
13076,168,165,140,98,64,35,2256,670,1586
13080,12,11,7,5,3,2,120,40,80
13081,4,4,4,3,1,2,84,18,66
13084,2,2,3,1,0,0,42,8,34
0,0,0,0,0,0,0,0,0,0
13114,1633,1331,921,685,445,225,18348,5240,13108
13117,1716,1532,1075,783,532,297,18444,5935,12509
13120,1723,1599,1157,855,595,322,20874,6251,14623
13122,1475,1341,1026,861,584,232,17550,5519,12031
13124,1003,826,577,475,269,162,13176,3312,9864
13126,1463,1145,927,704,422,225,17634,4886,12748
13128,1402,1166,898,686,446,226,16728,4824,11904
13130,1719,1395,949,711,472,291,18822,5537,13285
13134,768,706,539,444,258,162,9252,2877,6375
13136,12,13,10,8,6,3,258,52,206
13141,14,11,5,4,4,1,120,39,81
13142,195,167,137,105,73,37,2718,714,2004
13144,10,10,10,9,7,1,102,47,55
13145,4,4,3,1,0,0,66,12,54
13147,4,3,1,4,0,1,84,13,71
13149,66,54,36,28,18,9,918,211,707
13153,76,67,36,37,22,20,876,258,618
13163,86,81,80,54,29,24,1368,354,1014
13166,4,4,5,3,1,2,90,19,71
13179,34,25,21,14,18,8,462,120,342
13189,998,813,581,402,247,124,12174,3165,9009
13191,819,655,549,354,242,143,10380,2762,7618
13195,2023,1635,1166,836,581,305,21630,6546,15084
13198,1440,1280,937,643,451,244,17196,4995,12201
13200,1730,1381,1103,729,448,261,20442,5652,14790
13202,3528,2921,1984,1402,979,456,38568,11270,27298
13204,1341,1020,834,622,351,208,15114,4376,10738
13213,207,188,133,108,65,39,2652,740,1912
13219,138,112,82,68,44,28,2088,472,1616
13221,3,1,0,0,1,1,54,6,48
13222,2,3,2,2,1,0,36,10,26
13223,7,6,7,5,1,2,84,28,56
13224,283,250,192,137,84,40,3504,986,2518
13226,15,13,7,5,1,1,168,42,126
13228,6,10,9,8,3,2,120,38,82
13229,189,136,102,65,33,30,2022,555,1467
13242,6,5,4,3,2,2,42,22,20
13246,90,64,37,24,24,5,1026,244,782
13248,87,67,36,33,16,16,1134,255,879
13253,5,2,2,2,0,0,48,11,37
13254,4,4,3,3,2,0,48,16,32
13256,1,3,1,1,0,0,30,6,24
13257,1,2,1,2,0,0,48,6,42
13258,289,256,177,136,74,49,3144,981,2163
13261,9,9,6,3,3,0,108,30,78
13262,6,7,3,3,1,2,78,22,56
13263,14,7,8,4,2,1,126,36,90
13264,200,183,137,103,51,39,2586,713,1873
13270,122,96,75,26,16,12,1392,347,1045
13277,8,6,5,5,2,3,78,29,49
13286,968,831,642,439,300,156,11406,3336,8070
13304,988,912,671,500,382,177,12096,3630,8466
0,0,0,0,0,0,0,0,0,0
13337,236,197,120,83,53,32,2412,721,1691
13342,1434,1290,899,670,442,238,16530,4973,11557
13344,1238,1103,756,560,366,207,14568,4230,10338
13346,1854,1533,1051,746,450,279,19962,5913,14049
13348,1257,1018,779,621,341,220,15594,4236,11358
13350,1363,1257,870,651,392,245,16146,4778,11368
13352,54,39,28,17,11,7,798,156,642
13356,191,168,121,112,80,42,2604,714,1890
13358,7,8,5,2,3,2,90,27,63
13362,232,217,174,117,73,34,2886,847,2039
13366,8,7,9,4,3,1,84,32,52
13378,115,89,87,65,59,21,1206,436,770
13385,198,174,127,109,58,40,2850,706,2144
13400,285,252,178,117,54,59,3552,945,2607
13411,150,117,74,63,33,16,1716,453,1263
13423,1048,988,678,527,315,172,12720,3728,8992
13425,1287,1056,836,568,357,202,14898,4306,10592
13427,1931,1713,1148,773,488,296,20976,6349,14627
13429,1386,1077,798,572,343,226,15708,4402,11306
13431,651,554,423,290,162,110,8286,2190,6096
13433,1471,1173,907,630,406,224,17112,4811,12301
13435,1349,1244,915,709,478,237,16464,4932,11532
13437,1209,1100,773,577,379,167,13926,4205,9721
13439,46,35,30,19,6,3,516,139,377
13443,111,96,62,50,31,12,1428,362,1066
13476,205,181,116,89,43,46,2484,680,1804
13486,187,157,126,76,55,26,2148,627,1521
13492,9,8,4,4,2,1,72,28,44
13495,5,5,2,3,1,0,48,16,32
13497,6,4,1,0,1,1,66,13,53
13510,273,219,135,112,67,40,3318,846,2472
13518,193,167,110,81,43,22,2394,616,1778
13520,2,2,4,1,1,2,60,12,48
13523,4,4,2,2,0,0,60,12,48
13524,6,5,3,2,3,1,66,20,46
13525,132,87,40,34,15,16,1356,324,1032
13528,131,87,87,51,56,49,1434,461,973
13536,174,146,94,77,55,22,2040,568,1472
13541,13,6,5,3,2,0,84,29,55
13547,1765,1216,800,465,365,195,18288,4806,13482
13549,1777,1502,992,747,542,252,20136,5812,14324
13551,1130,984,697,453,321,167,14022,3752,10270
13553,1740,1470,1130,793,512,249,19932,5894,14038
13555,1607,1394,979,757,469,286,19674,5492,14182
13576,329,315,231,168,127,74,3948,1244,2704
13579,13,10,8,9,3,1,144,44,100
13581,149,133,98,68,43,21,1872,512,1360
13583,139,120,77,39,24,14,1518,413,1105
13585,179,147,87,42,33,34,2250,522,1728
13587,7,2,2,0,2,1,54,14,40
13589,3,2,2,1,0,0,30,8,22
13590,4,4,0,0,0,0,42,8,34
13592,8,5,3,2,0,0,66,18,48
13593,8,5,3,2,0,0,66,18,48
13632,126,95,63,42,31,13,1458,370,1088
13638,133,113,99,58,30,25,1764,458,1306
13641,10,5,5,4,0,2,114,26,88
13645,3,3,2,2,1,0,24,11,13
13646,92,65,39,15,9,8,1110,228,882
13650,216,181,138,97,67,25,2412,724,1688
13652,298,246,207,142,88,56,3474,1037,2437
13654,8,4,3,2,0,0,78,17,61
13657,8,5,4,4,2,1,96,24,72
13664,1343,1102,771,516,354,208,14490,4294,10196
13666,1354,1190,859,641,438,200,15894,4682,11212
13668,2059,1862,1399,1196,850,335,24354,7701,16653
13670,1438,1167,869,579,398,221,16122,4672,11450
13672,1790,1446,977,721,456,285,20190,5675,14515
13674,1336,1028,789,542,300,211,16140,4206,11934
13676,800,698,489,363,262,133,9246,2745,6501
13678,1630,1391,999,719,518,262,18204,5519,12685
13680,12,8,6,6,3,0,108,35,73
13682,143,106,79,40,17,15,1512,400,1112
13687,144,145,96,69,38,35,1782,527,1255
13696,4,5,3,3,1,1,72,17,55
13697,10,13,10,7,2,5,126,47,79
13699,185,155,72,56,31,18,2298,517,1781
13716,36,21,19,12,9,9,462,106,356
13720,298,222,149,107,63,40,3156,879,2277
13732,4,7,5,3,1,3,54,23,31
13735,11,11,10,5,5,2,84,44,40
13767,3,5,4,3,6,1,54,22,32
13768,16,13,8,6,5,2,168,50,118
13769,7,6,3,2,2,1,66,21,45
13773,367,324,228,170,101,53,4200,1243,2957
13771,6,6,5,3,4,2,102,26,76
13772,5,7,5,4,3,2,102,26,76
13775,167,161,114,82,42,39,2334,605,1729
13777,275,220,152,112,83,42,3378,884,2494
13781,1030,891,674,501,353,172,12300,3621,8679
13783,1521,1355,962,652,400,200,17328,5090,12238
13785,1621,1313,884,601,379,247,18468,5045,13423
13787,886,772,577,414,256,169,11280,3074,8206
13791,1020,901,704,509,322,157,12498,3613,8885
13793,983,884,692,493,331,149,12282,3532,8750
13795,1774,1556,1220,944,635,247,20364,6376,13988
13797,1689,1514,1166,851,540,313,21792,6073,15719
13803,252,226,156,116,79,37,2742,866,1876
13805,11,9,8,6,4,2,108,40,68
13808,226,173,101,60,42,41,2568,643,1925
13810,117,118,89,65,48,20,1578,457,1121
13812,8,7,6,4,2,1,90,28,62
13813,12,10,9,6,6,2,132,45,87
13819,7,8,9,4,3,1,120,32,88
13823,131,103,74,51,31,29,1596,419,1177
13827,928,755,497,339,182,126,10692,2827,7865
13835,6,4,2,0,0,1,78,13,65
13837,10,9,4,4,2,2,96,31,65
13840,54,47,34,24,18,6,714,183,531
13872,118,106,90,77,54,12,1746,457,1289
13876,11,9,5,4,1,1,114,31,83
13880,101,93,66,56,32,12,1356,360,996
13886,124,79,51,43,24,22,1560,343,1217
13891,4,6,1,1,0,1,90,13,77
13892,982,761,583,373,226,148,11202,3073,8129
13894,1181,979,661,415,320,175,12708,3731,8977
13896,1608,1415,1082,766,588,220,17496,5679,11817
13898,1333,1179,850,632,451,220,15870,4665,11205
13900,521,360,278,197,117,99,5958,1572,4386
13902,1346,1171,958,788,504,218,17274,4985,12289
13904,1049,864,708,575,420,154,12852,3770,9082
13906,1407,1195,901,683,398,271,16782,4855,11927
13908,103,87,58,56,41,26,1386,371,1015
13910,203,163,116,89,50,37,2454,658,1796
13914,274,202,165,112,74,49,3150,876,2274
13926,17,10,11,6,4,4,162,52,110
0,0,0,0,0,0,0,0,0,0
13951,428,319,230,158,124,49,4590,1308,3282
13955,8,6,4,1,2,1,102,22,80
13958,471,418,344,242,147,100,5664,1722,3942
13962,64,69,52,45,30,16,972,276,696
13964,8,8,7,5,3,2,150,33,117
13966,66,47,26,19,9,9,744,176,568
13974,10,7,8,5,2,4,108,36,72
13976,11,13,7,6,2,7,138,46,92
13978,7,7,4,2,1,1,72,22,50
13981,6,5,2,2,2,1,54,18,36
13999,1191,963,694,458,286,195,13044,3787,9257
14001,1833,1561,1032,666,375,208,18564,5675,12889
14003,1358,1115,766,554,348,243,15282,4384,10898
14005,1940,1641,1149,897,545,263,23064,6435,16629
14009,1099,920,713,529,347,208,12774,3816,8958
14011,1100,947,691,447,312,155,12258,3652,8606
14015,118,122,82,65,55,17,1890,459,1431
14017,225,198,169,139,83,48,3120,862,2258
14035,212,188,121,95,69,46,2766,731,2035
14037,9,14,10,8,4,6,138,51,87
14041,12,9,10,8,8,2,156,49,107
14051,215,177,151,113,70,32,2262,758,1504
14053,9,5,8,3,2,0,102,27,75
14065,115,100,69,41,27,16,1170,368,802
14068,22,16,12,4,6,4,168,64,104
14069,58,52,42,35,21,7,864,215,649
14073,115,112,100,78,45,15,2034,465,1569
14090,4,3,4,3,2,0,42,16,26
14091,10,7,3,4,0,1,84,25,59
14094,1264,1035,836,600,427,202,14712,4364,10348
14096,1021,885,734,518,331,211,12462,3700,8762
14098,1822,1686,1250,955,715,303,21444,6731,14713
14100,1602,1328,967,722,520,238,17964,5377,12587
14102,943,856,609,491,315,151,12150,3365,8785
14104,1255,946,760,504,308,154,14112,3927,10185
14106,1243,1000,737,527,327,194,14058,4028,10030
14108,1563,1282,966,725,467,228,18648,5231,13417
14110,280,215,165,107,77,50,2964,894,2070
14115,172,155,115,80,53,23,2268,598,1670
14118,234,211,150,105,49,51,2778,800,1978
14122,11,8,8,6,4,3,96,40,56
14123,161,114,91,61,44,23,1806,494,1312
14128,11,8,8,6,4,3,96,40,56
14130,6,7,3,3,1,0,78,20,58
14148,6,5,3,3,0,5,96,22,74
14150,11,10,10,8,5,3,108,47,61
14152,10,11,4,3,3,2,120,33,87
14156,55,37,22,22,14,5,708,155,553
14178,267,199,130,98,67,35,2826,796,2030
14180,7,4,3,4,2,2,72,22,50
14181,13,8,6,5,5,3,108,40,68
14183,4,4,2,1,2,1,66,14,52
14188,308,282,218,158,89,77,4176,1132,3044
14190,124,109,84,60,37,26,1518,440,1078
14199,5,5,5,3,3,0,66,21,45
14200,1307,1076,813,569,368,236,16026,4369,11657
14202,1329,1188,814,602,444,208,15894,4585,11309
14204,1528,1254,898,710,424,261,18132,5075,13057
14206,1468,1240,940,713,422,315,16962,5098,11864
14219,120,112,74,63,41,46,1488,456,1032
14224,472,407,291,202,141,61,4872,1574,3298
14230,41,24,24,16,7,1,564,113,451
14235,12,9,9,3,3,5,138,41,97
14237,9,12,8,9,5,2,120,45,75
14240,12,14,5,8,3,3,138,45,93
14241,6,6,5,5,3,4,78,29,49
14242,78,57,32,18,15,11,678,211,467
14248,65,68,51,39,24,17,678,264,414
14250,181,162,142,107,63,31,2652,686,1966
14252,6,6,3,3,2,0,66,20,46
14253,7,6,7,4,2,1,126,27,99
14262,488,441,301,233,156,75,5424,1694,3730
14269,1,1,1,1,1,0,36,5,31
14274,259,191,135,93,57,43,2910,778,2132
14295,1,1,1,1,0,0,24,4,20
14300,5,3,3,1,0,1,48,13,35
14302,258,205,180,128,75,47,2904,893,2011
14321,160,110,77,52,24,25,1698,448,1250
14323,1511,1345,995,783,532,238,17982,5404,12578
14325,907,799,595,488,291,189,11544,3269,8275
14327,1116,1012,741,533,353,191,13248,3946,9302
14329,992,865,643,500,326,141,12750,3467,9283
14331,1152,990,746,599,449,145,13530,4081,9449
14333,1646,1366,1024,792,500,252,19296,5580,13716
14335,1645,1375,995,712,429,311,18624,5467,13157
14337,87,69,52,32,15,9,1314,264,1050
14339,230,196,128,96,67,33,2580,750,1830
14351,198,186,136,100,59,26,2508,705,1803
14356,6,4,4,0,1,0,54,15,39
14357,4,3,1,2,1,2,66,13,53
14361,50,56,45,30,15,8,816,204,612
14363,135,112,126,89,60,24,1950,546,1404
14372,3,2,2,1,1,0,36,9,27
14373,2,3,1,1,1,1,36,9,27
14376,154,129,71,56,33,26,1998,469,1529
14378,279,240,175,130,86,42,3096,952,2144
14380,3,2,1,1,0,0,36,7,29
14383,4,2,1,3,3,0,72,13,59
14384,166,168,124,89,72,50,2340,669,1671
14386,2,2,3,2,0,1,24,10,14
14387,3,3,4,3,2,0,42,15,27
14388,342,276,180,137,91,59,3864,1085,2779
14398,81,95,67,42,23,20,1080,328,752
14401,4,3,3,2,3,1,36,16,20
14424,1021,822,584,397,248,152,10608,3224,7384
14428,264,234,151,112,69,48,2844,878,1966
14430,1221,1021,808,633,334,218,14088,4235,9853
14432,1541,1344,1123,875,544,248,18828,5675,13153
14434,1522,1275,988,715,471,240,17778,5211,12567
14436,1288,1070,817,566,368,191,15036,4300,10736
14438,1249,1034,857,611,432,175,15294,4358,10936
14441,684,631,469,358,225,129,8346,2496,5850
14443,1164,1022,890,648,425,204,14682,4353,10329
14445,766,646,533,397,298,118,9426,2758,6668
14447,925,854,653,511,339,128,12456,3410,9046
14459,124,117,77,71,43,21,1572,453,1119
14468,4,3,2,2,1,0,48,12,36
14469,5,4,2,3,2,3,48,19,29
14470,267,223,152,119,60,62,2604,883,1721
14480,230,164,126,113,39,39,2790,711,2079
14489,92,74,72,52,25,8,1422,323,1099
14493,95,73,49,24,13,6,1104,260,844
0,0,0,0,0,0,0,0,0,0
14499,1,2,0,0,0,0,36,3,33
14502,293,261,187,120,79,38,3396,978,2418
14561,70,51,37,24,13,9,828,204,624
14566,435,393,250,154,103,81,4356,1416,2940
14572,9,7,6,2,1,2,96,27,69
14574,10,11,9,5,8,3,120,46,74
14587,93,107,91,65,40,30,1326,426,900
14592,14,14,11,7,2,3,126,51,75
14595,185,145,113,81,49,24,2166,597,1569
14604,5,3,2,2,1,0,42,13,29
14606,8,5,4,3,0,1,66,21,45
14611,1539,1392,978,658,546,272,16704,5385,11319
14613,0,0,0,0,0,0,0,0,0
14615,1489,1118,809,534,354,146,16542,4450,12092
14617,947,778,551,373,250,142,10920,3041,7879
14619,1157,927,732,475,302,156,12480,3749,8731
14621,757,636,516,417,257,124,9756,2707,7049
14625,0,0,0,0,0,0,0,0,0
14631,140,119,98,64,25,29,1656,475,1181
14638,403,354,233,136,78,68,4572,1272,3300
14679,10,7,6,5,0,2,96,30,66
14682,9,10,7,6,5,1,108,38,70
14683,11,10,6,3,2,0,102,32,70
14685,7,9,2,1,0,1,66,20,46
14695,236,193,134,100,60,32,2460,755,1705
14703,229,237,178,104,76,52,2694,876,1818
14717,1,1,1,0,0,0,30,3,27
14715,3,3,3,2,0,3,42,14,28
14725,141,114,114,73,39,22,1980,503,1477
0,0,0,0,0,0,0,0,0,0
14740,11,9,10,5,6,3,138,44,94
14750,5,2,5,5,3,0,60,20,40
14758,225,207,156,116,76,37,2712,817,1895
14771,1537,1252,979,722,451,235,17526,5176,12350
14773,1166,894,700,447,283,148,12258,3638,8620
14775,987,877,649,436,302,154,11226,3405,7821
14777,1123,991,662,491,357,194,13452,3818,9634
14783,720,639,540,370,229,121,9432,2619,6813
14785,1254,1098,861,650,389,209,15294,4461,10833
14787,258,208,138,100,57,51,3030,812,2218
14793,166,139,109,83,51,25,2112,573,1539
14799,110,105,89,63,36,18,1518,421,1097
14805,10,11,10,9,3,1,120,44,76
14809,249,229,193,126,88,56,3138,941,2197
14812,5,7,5,6,2,1,84,26,58
14816,8,9,10,7,4,4,102,42,60
14817,10,10,10,4,5,3,114,42,72
14819,13,12,6,1,2,3,138,37,101
14840,253,201,139,85,52,36,3102,766,2336
14846,5,5,2,2,3,1,60,18,42
14847,9,7,4,4,2,3,126,29,97
14855,213,190,154,105,76,30,2766,768,1998
14861,104,93,62,48,35,31,1230,373,857
14873,9,8,8,6,4,1,84,36,48
14874,122,104,82,71,64,22,1932,465,1467
14878,199,152,118,86,40,35,2310,630,1680
14881,893,705,517,414,232,127,10278,2888,7390
14885,1412,1088,816,556,321,210,15474,4403,11071
14887,1448,1126,782,543,334,226,16200,4459,11741
14891,655,547,441,373,236,107,8352,2359,5993
14893,0,0,0,0,0,0,0,0,0
14903,335,322,274,205,144,54,4638,1334,3304
14905,11,12,10,8,4,2,138,47,91
0,0,0,0,0,0,0,0,0,0
14910,216,126,108,68,39,17,2574,574,2000
14912,8,6,6,7,1,2,72,30,42
14927,194,151,98,81,57,33,2262,614,1648
14930,5,1,2,2,0,1,48,11,37
14933,5,6,5,3,3,0,66,22,44
14936,6,10,8,7,5,1,90,37,53
14951,160,134,99,67,50,34,1800,544,1256
14956,10,5,9,6,6,0,132,36,96
14957,14,14,7,5,4,3,138,47,91
14964,89,78,56,37,25,6,1206,291,915
14967,6,4,3,1,2,2,54,18,36
14968,6,7,5,6,5,2,84,31,53
14971,276,254,192,167,102,69,3738,1060,2678
14979,135,105,79,54,37,22,1812,432,1380
14984,2,3,3,4,1,2,42,15,27
14987,858,661,514,391,227,130,10752,2781,7971
14993,77,73,49,40,22,19,924,280,644
14998,250,201,143,96,47,44,2844,781,2063
15003,140,136,108,80,62,20,1992,546,1446
15005,7,8,6,3,3,3,96,30,66
15008,7,4,6,3,2,1,108,23,85
15009,9,8,4,4,4,3,108,32,76
15013,3,3,4,3,2,0,78,15,63
15016,5,6,4,4,1,1,54,21,33
15040,213,189,133,106,75,36,2502,752,1750
0,0,0,0,0,0,0,0,0,0
15074,232,208,160,128,73,68,2640,869,1771
15076,62,57,42,34,32,9,900,236,664
0,0,0,0,0,0,0,0,0,0
15084,343,352,248,183,131,51,4542,1308,3234
15092,9,8,8,7,2,2,114,36,78
15096,1841,1536,1191,846,508,275,21330,6197,15133
15098,1481,1170,854,586,377,245,15666,4713,10953
15102,1633,1380,952,713,484,244,18690,5406,13284
15104,0,0,0,0,0,0,0,0,0
15106,694,540,402,318,222,98,8118,2274,5844
15108,0,0,0,0,0,0,0,0,0
15110,1377,1101,898,675,443,198,16134,4692,11442
15112,1170,967,706,499,370,142,13116,3854,9262
15117,64,65,36,27,12,9,672,213,459
15125,404,359,240,177,114,85,4296,1379,2917
15129,528,487,345,263,179,94,6960,1896,5064
15135,11,11,9,9,2,1,120,43,77
15137,10,10,8,7,7,2,132,44,88
15140,205,208,158,121,63,42,2892,797,2095
15147,53,47,34,33,13,13,678,193,485
15154,104,103,60,38,38,42,1308,385,923
15163,77,72,47,43,28,18,954,285,669
15167,7,8,6,4,2,5,78,32,46
15171,192,158,140,95,36,29,2178,650,1528
15177,770,599,427,323,212,116,8196,2447,5749
15179,172,146,109,84,61,29,2766,601,2165
15181,0,0,0,0,0,0,0,0,0
15183,0,0,0,0,0,0,0,0,0
15185,1555,1213,891,626,460,265,16746,5010,11736
15188,101,88,61,40,30,17,1116,337,779
15219,160,141,111,89,61,31,2166,593,1573
15223,9,11,8,6,3,1,102,38,64
15224,8,9,6,5,5,4,96,37,59
0,0,0,0,0,0,0,0,0,0
15252,273,207,163,115,64,39,3216,861,2355
15254,2,2,1,0,0,1,48,6,42
437,24,18,7,6,1,1,216,57,159
24,1192,999,698,543,286,221,13668,3939,9729
4778,16,15,6,2,4,2,168,45,123
4821,8,8,6,2,0,2,108,26,82
0,0,0,0,0,0,0,0,0,0
3569,174,164,115,56,27,39,2370,575,1795
5424,66,56,32,21,15,13,690,203,487
5374,11,11,9,6,4,5,102,46,56
5378,6,4,3,1,3,1,72,18,54
0,0,0,0,0,0,0,0,0,0
4978,9,9,5,4,2,0,114,29,85
459,17,14,9,8,4,4,204,56,148
551,267,241,150,103,74,39,2940,874,2066
4560,21,22,11,9,7,3,216,73,143
593,10,9,6,2,3,1,96,31,65
778,8,6,5,1,1,2,90,23,67
5336,15,16,7,8,2,5,150,53,97
5333,13,16,11,8,7,6,162,61,101
767,2,4,2,1,0,0,42,9,33
782,14,11,7,6,5,2,132,45,87
4559,8,10,7,6,3,2,96,36,60
797,14,13,10,7,2,4,162,50,112
4822,14,14,9,5,3,1,132,46,86
830,6,6,3,3,0,1,60,19,41
854,7,6,3,2,3,1,84,22,62
860,7,6,3,2,3,1,84,22,62
898,0,3,2,1,1,2,42,9,33
925,8,7,6,5,2,1,78,29,49
969,13,11,7,5,5,1,144,42,102
4993,85,74,58,39,21,16,876,293,583
1054,20,15,7,11,7,4,174,64,110
1069,4,3,3,3,3,2,72,18,54
1072,6,4,3,4,4,0,102,21,81
4810,18,18,9,6,4,4,186,59,127
5232,5,3,1,0,0,0,66,9,57
5236,6,7,3,2,3,2,102,23,79
5229,4,7,4,3,3,0,66,21,45
0,0,0,0,0,0,0,0,0,0
4731,6,5,4,0,0,2,78,17,61
4601,281,259,218,163,104,41,4386,1066,3320
1184,16,17,10,9,8,3,138,63,75
0,0,0,0,0,0,0,0,0,0
5172,13,12,9,7,5,3,162,49,113
0,0,0,0,0,0,0,0,0,0
1472,218,195,170,110,90,44,2538,827,1711
1508,131,109,72,70,43,30,1578,455,1123
5288,3,2,1,2,0,1,60,9,51
5291,6,7,4,4,2,3,78,26,52
5273,11,8,6,2,2,2,132,31,101
0,0,0,0,0,0,0,0,0,0
4888,6,6,4,6,1,2,78,25,53
4889,6,6,4,6,1,2,72,25,47
4781,9,7,5,4,4,1,96,30,66
4782,364,285,231,139,80,45,4014,1144,2870
1630,11,4,6,5,1,2,102,29,73
1648,3,1,1,2,1,0,30,8,22
1652,9,6,6,4,1,1,90,27,63
4949,2,1,1,1,1,0,48,6,42
4950,22,22,11,5,6,4,204,70,134
4951,4,4,5,2,1,1,66,17,49
0,0,0,0,0,0,0,0,0,0
4953,14,11,8,4,5,2,120,44,76
4955,16,14,12,7,6,4,174,59,115
5109,19,18,14,10,5,5,180,71,109
5110,12,8,3,4,2,1,126,30,96
5130,12,10,5,2,3,1,120,33,87
1807,7,5,1,5,0,3,66,21,45
1731,10,7,6,6,4,4,114,37,77
1748,242,171,140,98,60,30,2562,741,1821
5151,11,12,7,6,4,1,132,41,91
1811,2,1,1,1,0,0,30,5,25
3832,647,511,370,250,164,100,7812,2042,5770
3749,78,62,46,21,17,18,1086,242,844
5100,4,7,4,4,1,5,54,25,29
5102,10,12,7,5,5,4,102,43,59
1849,10,10,11,7,4,3,120,45,75
5082,10,14,13,11,8,3,138,59,79
5081,12,14,13,6,6,5,144,56,88
5065,6,9,5,6,3,1,102,30,72
1912,10,11,8,3,0,4,102,36,66
4796,1,3,2,0,2,0,42,8,34
4901,7,7,5,2,1,1,72,23,49
4903,8,4,4,3,0,3,72,22,50
4904,7,4,2,1,0,1,78,15,63
4905,11,12,13,6,3,2,108,47,61
4906,5,8,5,3,2,1,78,24,54
4907,6,7,4,4,3,2,78,26,52
4910,3,2,1,3,0,0,36,9,27
5040,8,10,6,8,3,2,114,37,77
5028,8,10,9,8,4,3,102,42,60
5029,12,13,10,7,7,3,120,52,68
5034,14,12,10,7,4,3,144,50,94
5024,3,4,3,3,3,1,48,17,31
5027,6,8,3,2,1,1,84,21,63
5003,17,11,6,2,2,4,138,42,96
5043,288,250,140,107,54,51,3612,890,2722
4998,12,10,11,5,3,0,174,41,133
4999,6,4,1,2,0,1,72,14,58
5000,6,12,7,8,1,6,108,40,68
5001,8,8,3,3,2,0,114,24,90
4913,8,6,6,4,2,2,114,28,86
4960,6,5,5,4,0,2,72,22,50
1985,8,7,6,5,1,4,84,31,53
4921,6,7,4,5,3,2,108,27,81
4923,7,8,6,5,4,1,90,31,59
2018,165,130,80,57,29,23,2202,484,1718
2024,5,4,5,0,1,0,66,15,51
2026,13,10,9,6,2,3,144,43,101
4892,4,3,3,3,1,0,42,14,28
4894,10,7,8,7,5,0,108,37,71
4895,6,4,2,0,1,1,66,14,52
4896,17,15,9,4,4,4,138,53,85
4791,11,11,7,4,5,3,114,41,73
4792,7,4,4,2,0,0,54,17,37
4793,8,6,4,4,2,1,66,25,41
4794,10,6,5,2,0,3,96,26,70
2143,11,10,9,7,3,4,120,44,76
2145,21,17,12,7,5,3,264,65,199
2147,15,11,11,8,5,1,198,51,147
2170,9,10,6,5,1,2,90,33,57
2252,2,1,2,2,1,1,36,9,27
2280,4,3,1,2,0,0,48,10,38
2284,6,5,5,5,3,2,66,26,40
2289,10,10,7,7,3,4,120,41,79
2989,6,5,6,2,3,2,72,24,48
3071,19,15,14,9,6,5,210,68,142
4020,2,3,1,0,2,1,54,9,45
2941,9,9,14,9,3,6,150,50,100
0,0,0,0,0,0,0,0,0,0
0,0,0,0,0,0,0,0,0,0
3616,195,183,131,103,78,37,2706,727,1979
3099,17,11,6,3,1,0,126,38,88
3086,8,7,5,3,1,1,108,25,83
3999,16,13,10,6,5,5,162,55,107
2471,11,10,5,4,5,1,126,36,90
2477,18,15,8,8,4,3,174,56,118
2479,11,14,8,7,6,4,132,50,82
2503,9,8,5,4,1,1,96,28,68
2505,15,13,5,2,2,1,132,38,94
2510,9,6,2,2,1,1,114,21,93
4003,3,4,1,2,3,2,48,15,33
3282,169,164,108,89,52,49,1992,631,1361
2647,4,5,4,4,2,0,60,19,41
3596,3,2,1,2,2,0,36,10,26
2663,4,2,3,2,1,1,66,13,53
4006,18,10,7,5,5,0,162,45,117
2669,9,6,6,6,5,3,108,35,73
2703,15,13,4,4,5,3,150,44,106
2708,5,3,3,2,1,1,60,15,45
2710,6,3,2,1,0,2,84,14,70
2712,6,8,3,4,3,2,90,26,64
2714,9,9,3,3,3,1,114,28,86
2718,6,9,4,4,2,2,102,27,75
2754,162,119,92,66,38,27,1746,504,1242
2796,9,8,6,6,2,3,120,34,86
2800,6,6,5,5,2,2,72,26,46
5346,6,5,7,4,2,2,96,26,70
5348,12,14,8,2,3,1,144,40,104
5167,794,697,519,365,256,147,9474,2778,6696
3035,6,6,2,0,0,0,66,14,52
3049,6,5,3,3,3,2,48,22,26
3065,360,276,178,110,59,55,3690,1038,2652
3426,11,14,8,6,2,2,156,43,113
3461,9,11,10,6,3,3,126,42,84
3463,10,9,8,5,4,1,102,37,65
3491,172,150,99,52,47,33,1842,553,1289
3474,4,4,3,2,2,1,60,16,44
3473,11,10,11,8,4,2,126,46,80
3502,4,6,4,3,2,1,90,20,70
3503,7,3,3,2,3,0,72,18,54
0,0,0,0,0,0,0,0,0,0
3507,7,10,10,8,7,2,126,44,82
3508,10,8,7,4,1,2,102,32,70
3511,7,7,8,6,3,1,102,32,70
3656,99,114,87,61,49,15,1602,425,1177
0,0,0,0,0,0,0,0,0,0
3643,2093,1539,1054,692,407,263,22902,6048,16854
3635,389,322,243,165,102,74,5010,1295,3715
3637,3,2,1,1,2,0,102,9,93
3661,132,146,114,87,66,38,1596,583,1013
3699,10,13,9,7,3,3,102,45,57
3702,7,7,6,3,2,0,90,25,65
3703,9,3,4,2,2,2,90,22,68
3704,10,9,9,6,4,2,96,40,56
3707,74,66,56,43,27,8,984,274,710
3731,231,222,182,127,85,48,2856,895,1961
3844,398,329,249,135,88,42,4050,1241,2809
3857,1504,1219,924,664,400,226,16494,4937,11557
3873,49,35,20,10,9,6,606,129,477
3880,86,106,83,56,31,24,2190,386,1804
3904,91,74,49,37,14,12,774,277,497
3923,12,13,10,10,6,2,102,53,49
3955,512,426,278,198,96,90,5274,1600,3674
3925,2,1,2,2,0,1,36,8,28
3928,6,4,2,2,5,0,66,19,47
3945,11,9,7,7,2,5,120,41,79
3953,47,44,35,26,17,11,798,180,618
3961,7,6,8,4,2,2,72,29,43
3963,16,10,5,6,1,2,144,40,104
3964,16,15,11,8,4,6,150,60,90
3965,23,13,11,8,2,5,180,62,118
3966,8,8,7,7,3,5,96,38,58
3967,8,8,7,7,3,5,96,38,58
3968,16,13,8,5,4,2,150,48,102
3972,7,9,6,4,1,1,96,28,68
0,0,0,0,0,0,0,0,0,0
0,0,0,0,0,0,0,0,0,0
3987,234,209,162,110,73,56,2508,844,1664
4021,18,19,11,8,2,3,198,61,137
4022,18,19,11,8,2,3,198,61,137
4023,9,7,5,5,2,3,90,31,59
4025,341,283,263,193,144,31,4722,1255,3467
4033,29,30,14,13,9,3,354,98,256
4040,211,191,123,96,68,44,2472,733,1739
4045,9,9,2,3,2,0,78,25,53
4046,4,6,5,3,5,1,78,24,54
4047,7,8,6,7,4,1,102,33,69
4048,9,7,6,6,2,1,114,31,83
4049,9,7,6,6,2,1,114,31,83
4050,14,9,12,10,6,1,126,52,74
4052,3,2,1,1,1,0,36,8,28
4054,10,7,6,8,6,2,102,39,63
4071,15,11,5,2,1,0,174,34,140
4072,10,7,9,5,3,0,120,34,86
4073,8,9,7,3,4,1,90,32,58
4074,4,4,1,3,2,1,54,15,39
4075,5,5,3,3,0,5,72,21,51
4126,7,8,2,3,1,0,78,21,57
4128,6,6,3,2,0,1,126,18,108
4130,6,5,5,5,2,2,90,25,65
4132,8,9,9,6,4,3,138,39,99
4135,2,3,0,1,1,0,66,7,59
4135,2,3,0,1,1,0,66,7,59
4137,10,11,9,6,7,2,156,45,111
4138,7,6,5,5,5,1,72,29,43
4139,8,10,6,6,5,0,144,35,109
4141,6,5,4,5,3,0,96,23,73
4145,5,4,5,3,0,1,96,18,78
4148,5,3,1,2,0,1,66,12,54
4149,16,16,12,7,5,4,216,60,156
4187,3,3,2,2,1,1,54,12,42
4188,4,6,3,3,3,2,90,21,69
4189,16,9,9,8,4,3,162,49,113
4191,16,8,8,2,1,0,138,35,103
4194,5,3,3,1,0,2,42,14,28
15196,21,17,11,6,6,3,216,64,152
6427,4,3,2,2,0,0,60,11,49
4251,11,10,7,5,1,2,144,36,108
4256,11,8,5,3,1,3,132,31,101
4257,17,14,11,6,6,4,216,58,158
4259,19,17,12,6,2,3,222,59,163
4303,194,123,89,46,41,27,2136,520,1616
4309,8,5,4,2,1,0,78,20,58
4314,11,10,11,5,4,2,180,43,137
4317,7,7,3,3,2,2,72,24,48
4318,7,7,7,2,1,2,150,26,124
4319,9,6,4,1,1,0,138,21,117
4320,9,8,6,4,2,2,102,31,71
4322,15,16,8,4,6,2,150,51,99
4324,11,5,2,1,1,1,96,21,75
4374,3,4,3,3,3,1,42,17,25
4389,11,8,5,3,5,0,114,32,82
4396,9,5,7,6,5,0,78,32,46
4402,6,5,5,3,1,3,72,23,49
4405,3,3,4,2,2,2,60,16,44
4407,5,4,4,2,2,0,60,17,43
4408,3,4,2,3,2,0,60,14,46
4409,2,3,3,4,1,1,54,14,40
4410,7,7,3,2,1,3,66,23,43
4411,4,5,3,1,2,0,60,15,45
4413,1,2,2,3,2,1,48,11,37
4415,5,2,1,1,0,1,66,10,56
0,0,0,0,0,0,0,0,0,0
4418,7,7,6,5,3,2,72,30,42
4419,2,4,0,2,0,0,54,8,46
4434,9,4,2,2,0,3,96,20,76
4435,6,5,5,2,1,2,102,21,81
4485,3,4,2,1,2,1,60,13,47
4472,7,2,2,1,0,1,48,13,35
4473,4,4,3,2,2,0,72,15,57
4474,8,8,5,3,2,1,84,27,57
4479,7,8,7,6,5,4,90,37,53
4507,9,9,5,3,6,3,108,35,73
4510,6,6,2,3,4,1,84,22,62
4511,5,7,3,4,1,3,60,23,37
4512,5,7,4,1,3,1,78,21,57
4513,8,11,7,3,3,4,96,36,60
4514,9,7,5,3,2,2,90,28,62
4515,9,7,5,3,2,2,90,28,62
4540,7,5,6,4,3,2,90,27,63
4546,9,8,3,4,2,5,78,31,47
4547,9,9,10,6,4,3,126,41,85
4549,6,8,6,7,5,0,90,32,58
4550,3,6,4,2,2,0,72,17,55
4552,6,5,2,2,2,1,84,18,66
4638,9,10,4,4,2,3,102,32,70
4586,54,55,39,35,14,12,654,209,445
4611,7,7,4,5,3,2,90,28,62
4615,11,9,8,4,3,1,102,36,66
4618,12,12,8,5,6,1,132,44,88
4621,12,12,10,11,4,4,114,53,61
4639,4,5,1,2,0,2,42,14,28
4640,7,9,8,5,2,0,120,31,89
4642,7,4,3,3,4,2,84,23,61
4643,6,6,5,4,2,2,66,25,41
4644,11,10,9,6,6,1,126,43,83
4684,440,392,279,202,100,85,4680,1498,3182
4647,3,3,1,1,0,1,54,9,45
4671,9,10,11,11,10,3,132,54,78
4675,7,10,8,8,3,5,114,41,73
4676,7,8,8,6,4,4,114,37,77
4890,9,7,4,4,4,0,108,28,80
4774,15,13,9,6,4,2,144,49,95
4744,7,11,6,3,4,1,126,32,94
4746,12,14,12,11,6,3,150,58,92
4747,12,14,12,11,6,3,150,58,92
4748,5,8,6,5,6,2,96,32,64
4749,3,3,2,1,1,3,36,13,23
4771,7,7,5,5,3,1,78,28,50
4773,1,3,2,2,2,1,24,11,13
4806,7,13,9,7,6,2,138,44,94
4814,8,9,8,4,2,5,96,36,60
4815,12,7,4,4,1,0,96,28,68
4818,6,4,4,3,0,0,78,17,61
4845,555,470,298,217,130,119,6306,1789,4517
5602,8,8,7,2,1,2,108,28,80
5611,14,13,12,8,5,6,120,58,62
5858,11,5,6,5,2,1,102,30,72
5859,7,6,2,3,1,1,72,20,52
5887,7,6,7,6,4,2,66,32,34
5891,48,39,23,19,10,6,606,145,461
5893,112,103,76,67,65,15,1638,438,1200
5915,6,5,3,3,2,1,114,20,94
5916,3,3,3,3,2,1,72,15,57
5921,9,8,5,2,0,2,102,26,76
5928,13,11,5,6,1,3,126,39,87
5929,15,14,12,5,2,2,138,50,88
5949,11,10,8,8,6,1,120,44,76
5954,14,10,9,7,2,1,156,43,113
5960,9,8,6,3,2,3,126,31,95
5985,4,2,1,2,1,0,48,10,38
5994,14,12,8,5,2,1,132,42,90
6017,12,8,8,6,1,5,108,40,68
6020,10,9,10,7,5,3,120,44,76
6046,74,51,25,14,7,8,624,179,445
6057,11,11,6,6,7,1,132,42,90
6059,7,7,7,4,2,4,102,31,71
6065,16,13,9,4,4,1,126,47,79
6089,7,4,5,2,0,1,72,19,53
6182,198,155,113,72,39,34,2208,611,1597
6118,2,5,3,3,2,2,54,17,37
6123,1,4,5,4,3,1,90,18,72
6124,10,10,6,6,4,2,138,38,100
6146,8,9,7,6,2,4,126,36,90
6150,5,10,9,1,3,2,114,30,84
6180,10,3,4,1,0,0,84,18,66
6181,5,7,1,2,1,1,72,17,55
6201,199,164,107,59,38,31,2142,598,1544
6212,247,214,151,94,45,39,2958,790,2168
6234,5,2,0,0,1,2,66,10,56
6241,2,2,1,1,0,2,42,8,34
6242,102,106,79,67,32,26,1452,412,1040
6266,5,5,4,3,2,1,78,20,58
6267,7,7,5,2,2,1,78,24,54
6270,0,0,0,0,0,0,12,0,12
6294,7,9,9,5,3,1,114,34,80
6296,6,6,2,3,0,2,84,19,65
6300,9,7,5,4,3,1,102,29,73
6307,6,2,2,0,0,1,78,11,67
6308,10,11,7,5,3,1,150,37,113
6309,18,12,8,3,1,3,168,45,123
6310,12,13,10,7,4,2,162,48,114
6311,12,13,10,7,4,2,162,48,114
6336,9,10,6,4,4,5,126,38,88
6339,11,10,11,8,5,3,108,48,60
6344,8,11,6,7,3,3,138,38,100
6346,9,12,11,5,6,3,132,46,86
6347,9,12,11,5,6,3,132,46,86
6352,6,6,5,2,1,0,90,20,70
6359,8,6,3,4,2,1,84,24,60
6361,12,15,10,5,7,2,156,51,105
6374,9,5,4,3,2,1,90,24,66
6381,12,11,8,6,4,4,156,45,111
6406,10,12,9,7,4,4,132,46,86
6407,6,8,5,3,2,1,96,25,71
6410,10,10,5,6,4,4,132,39,93
6411,14,14,7,3,0,2,150,40,110
6415,10,8,6,3,1,3,120,31,89
6417,14,13,13,8,11,0,162,59,103
6419,4,6,3,4,3,1,78,21,57
6442,251,195,133,90,44,47,2742,760,1982
6449,2,3,1,2,0,1,30,9,21
6472,21,19,8,8,7,0,240,63,177
6493,4,5,4,4,3,0,60,20,40
6495,13,15,17,15,9,3,144,72,72
6497,2,3,2,2,2,0,42,11,31
6498,16,16,12,10,4,1,168,59,109
6500,14,13,7,3,4,4,138,45,93
6501,13,12,8,4,3,3,132,43,89
6502,11,8,8,3,4,1,120,35,85
6517,4,5,3,1,0,0,54,13,41
6539,7,5,4,3,2,2,96,23,73
6540,6,7,4,2,1,3,96,23,73
6541,15,13,12,9,7,3,156,59,97
6542,15,13,12,9,7,3,156,59,97
6543,15,13,12,9,7,3,156,59,97
6546,3,3,4,3,1,1,54,15,39
0,0,0,0,0,0,0,0,0,0
0,0,0,0,0,0,0,0,0,0
0,0,0,0,0,0,0,0,0,0
0,0,0,0,0,0,0,0,0,0
0,0,0,0,0,0,0,0,0,0
6613,14,10,12,9,8,2,156,55,101
6614,8,10,5,4,4,2,108,33,75
6615,8,10,5,4,4,2,108,33,75
6616,7,7,5,6,3,2,96,30,66
6618,4,3,2,2,2,1,78,14,64
0,0,0,0,0,0,0,0,0,0
0,0,0,0,0,0,0,0,0,0
0,0,0,0,0,0,0,0,0,0
6649,21,21,14,11,11,3,198,81,117
6656,5,7,5,3,0,2,72,22,50
6682,18,17,12,5,4,4,144,60,84
6683,1,1,1,1,1,1,12,6,6
0,0,0,0,0,0,0,0,0,0
6699,470,405,303,219,119,91,5502,1607,3895
6703,8,6,6,6,3,0,84,29,55
6705,10,12,6,7,3,2,126,40,86
6708,15,11,8,7,2,3,168,46,122
6711,7,5,4,2,2,2,84,22,62
6715,13,6,3,2,3,2,138,29,109
6721,6,5,7,4,3,4,114,29,85
0,0,0,0,0,0,0,0,0,0
0,0,0,0,0,0,0,0,0,0
6801,13,14,10,6,3,2,150,48,102
6806,16,14,7,5,3,2,168,47,121
6825,103,96,69,50,39,15,1320,372,948
0,0,0,0,0,0,0,0,0,0
0,0,0,0,0,0,0,0,0,0
8550,12,13,10,6,8,3,138,52,86
8551,12,13,10,6,8,3,138,52,86
0,0,0,0,0,0,0,0,0,0
6856,121,90,52,33,25,21,1272,342,930
6863,11,8,8,3,3,1,132,34,98
6864,10,9,4,3,3,1,114,30,84
6865,16,14,9,3,4,4,138,50,88
0,0,0,0,0,0,0,0,0,0
6894,9,7,8,6,5,2,102,37,65
6895,10,8,4,2,2,0,114,26,88
6896,5,3,5,3,2,1,42,19,23
0,0,0,0,0,0,0,0,0,0
6904,99,101,83,75,42,22,1422,422,1000
0,0,0,0,0,0,0,0,0,0
6919,12,11,11,7,4,1,156,46,110
6921,618,493,348,237,144,108,6780,1948,4832
6924,10,11,7,6,5,2,126,41,85
6927,4,6,7,3,0,2,96,22,74
0,0,0,0,0,0,0,0,0,0
0,0,0,0,0,0,0,0,0,0
6961,5,5,5,4,2,1,66,22,44
0,0,0,0,0,0,0,0,0,0
6974,7,6,5,6,1,2,90,27,63
6975,5,4,2,1,2,0,72,14,58
6976,13,13,5,5,3,1,114,40,74
6978,6,3,4,4,2,1,54,20,34
6980,8,9,8,2,2,0,108,29,79
6981,10,10,7,6,5,1,114,39,75
0,0,0,0,0,0,0,0,0,0
0,0,0,0,0,0,0,0,0,0
0,0,0,0,0,0,0,0,0,0
7023,331,300,226,137,107,61,4422,1162,3260
7026,8,8,5,2,3,1,108,27,81
7027,168,132,104,72,48,18,1818,542,1276
7050,10,8,6,3,3,2,108,32,76
7054,2,1,2,3,0,1,36,9,27
7055,15,8,6,6,3,5,132,43,89
7056,5,3,2,1,2,1,60,14,46
7058,7,7,3,2,1,2,60,22,38
0,0,0,0,0,0,0,0,0,0
0,0,0,0,0,0,0,0,0,0
7088,4,3,2,1,0,0,36,10,26
0,0,0,0,0,0,0,0,0,0
7120,295,262,156,114,72,44,3546,943,2603
7123,12,15,6,4,4,2,114,43,71
7124,3,4,0,1,0,1,48,9,39
7139,0,0,1,0,0,0,150,1,149
7143,16,16,6,7,2,4,162,51,111
7144,10,6,4,4,1,3,72,28,44
7147,11,19,13,6,5,4,156,58,98
0,0,0,0,0,0,0,0,0,0
0,0,0,0,0,0,0,0,0,0
7182,88,74,49,31,16,13,1038,271,767
7191,10,11,5,5,5,4,102,40,62
7198,8,8,4,5,2,1,66,28,38
7238,508,408,303,196,153,94,5484,1662,3822
7240,7,5,2,1,1,0,60,16,44
7246,7,6,2,4,0,1,72,20,52
7247,5,6,3,3,2,2,78,21,57
0,0,0,0,0,0,0,0,0,0
0,0,0,0,0,0,0,0,0,0
0,0,0,0,0,0,0,0,0,0
0,0,0,0,0,0,0,0,0,0
0,0,0,0,0,0,0,0,0,0
0,0,0,0,0,0,0,0,0,0
0,0,0,0,0,0,0,0,0,0
0,0,0,0,0,0,0,0,0,0
7373,6,9,7,6,4,5,96,37,59
7377,9,7,7,4,0,4,78,31,47
7382,10,10,6,3,1,2,126,32,94
7383,18,17,13,11,6,1,156,66,90
7384,18,17,13,11,6,1,156,66,90
7387,5,6,5,4,2,1,60,23,37
7390,13,8,7,5,3,4,150,40,110
7391,4,3,2,2,3,2,54,16,38
0,0,0,0,0,0,0,0,0,0
0,0,0,0,0,0,0,0,0,0
8419,6,5,7,3,3,2,66,26,40
0,0,0,0,0,0,0,0,0,0
7438,9,10,10,7,4,3,132,43,89
7454,16,14,15,10,6,1,144,62,82
0,0,0,0,0,0,0,0,0,0
0,0,0,0,0,0,0,0,0,0
7498,5,5,5,2,2,1,66,20,46
7501,1,3,0,1,0,0,30,5,25
7506,11,10,4,2,2,0,144,29,115
7508,7,6,5,0,0,3,90,21,69
7511,8,7,5,4,3,1,84,28,56
7512,5,5,5,3,3,1,90,22,68
7517,2,2,1,1,2,1,24,9,15
7519,10,9,7,4,2,3,120,35,85
0,0,0,0,0,0,0,0,0,0
0,0,0,0,0,0,0,0,0,0
7563,209,159,150,136,96,33,2712,783,1929
7568,9,10,9,7,8,1,132,44,88
7569,4,3,1,2,1,0,66,11,55
7575,7,7,5,2,1,0,90,22,68
7578,4,5,1,1,1,0,60,12,48
7579,7,8,5,2,3,1,114,26,88
7580,5,4,1,2,1,0,36,13,23
7586,4,4,0,1,0,0,42,9,33
7588,6,6,7,5,3,0,66,27,39
0,0,0,0,0,0,0,0,0,0
0,0,0,0,0,0,0,0,0,0
0,0,0,0,0,0,0,0,0,0
8401,274,237,163,109,53,32,2982,868,2114
7630,5,2,1,1,0,1,48,10,38
7631,91,78,49,38,31,19,1314,306,1008
7652,2,3,4,3,1,1,42,14,28
7654,3,4,2,0,1,3,42,13,29
7655,9,8,9,6,3,4,126,39,87
7656,14,10,7,4,3,4,138,42,96
7657,9,9,6,5,3,1,96,33,63
7668,7,7,7,3,3,1,138,28,110
7671,9,10,5,3,1,4,114,32,82
7673,7,9,4,2,3,1,90,26,64
0,0,0,0,0,0,0,0,0,0
7683,6,6,5,4,3,1,72,25,47
7684,4,7,3,1,1,2,66,18,48
7703,10,12,8,5,5,3,114,43,71
7709,0,1,1,1,0,1,18,4,14
7710,433,319,233,158,110,68,5304,1321,3983
7717,11,5,5,3,1,2,138,27,111
7719,4,4,3,2,2,1,42,16,26
7721,694,626,424,322,279,106,8064,2451,5613
7732,16,14,12,8,3,4,150,57,93
7734,10,12,7,4,4,3,108,40,68
7749,5,4,3,2,0,1,60,15,45
7750,59,57,42,34,23,13,804,228,576
7760,11,9,5,5,6,2,102,38,64
0,0,0,0,0,0,0,0,0,0
0,0,0,0,0,0,0,0,0,0
0,0,0,0,0,0,0,0,0,0
0,0,0,0,0,0,0,0,0,0
0,0,0,0,0,0,0,0,0,0
0,0,0,0,0,0,0,0,0,0
0,0,0,0,0,0,0,0,0,0
0,0,0,0,0,0,0,0,0,0
0,0,0,0,0,0,0,0,0,0
0,0,0,0,0,0,0,0,0,0
7860,2,4,3,3,3,1,48,16,32
7861,134,117,88,48,33,20,1530,440,1090
7864,4,4,4,0,1,0,72,13,59
7870,12,9,9,6,4,3,156,43,113
7873,253,229,184,153,82,36,3888,937,2951
7878,5,6,3,6,1,1,90,22,68
7900,6,6,4,4,1,1,78,22,56
7902,8,4,6,3,2,2,114,25,89
7903,15,11,7,5,5,4,156,47,109
7905,209,155,113,76,39,33,2514,625,1889
7911,9,10,9,6,4,4,120,42,78
7912,10,7,4,3,0,2,90,26,64
7915,3,4,4,3,2,2,90,18,72
7916,11,7,9,5,2,1,126,35,91
7917,12,10,5,7,3,3,132,40,92
7919,9,9,5,3,3,2,114,31,83
7938,9,8,8,3,3,0,114,31,83
7939,3,5,2,1,2,0,78,13,65
7940,10,6,7,5,2,2,114,32,82
7943,1,2,1,0,0,0,18,4,14
7945,2,3,1,1,0,1,24,8,16
7946,3,2,1,1,1,1,24,9,15
7948,4,5,4,2,0,2,54,17,37
7949,1,1,1,1,2,1,24,7,17
7953,255,240,207,161,103,54,3264,1020,2244
7975,5,4,3,4,3,3,84,22,62
7983,3,3,1,2,1,2,60,12,48
7987,79,89,53,38,28,21,912,308,604
7989,16,15,8,9,6,3,180,57,123
7991,10,6,7,6,0,4,108,33,75
0,0,0,0,0,0,0,0,0,0
0,0,0,0,0,0,0,0,0,0
0,0,0,0,0,0,0,0,0,0
0,0,0,0,0,0,0,0,0,0
0,0,0,0,0,0,0,0,0,0
0,0,0,0,0,0,0,0,0,0
0,0,0,0,0,0,0,0,0,0
0,0,0,0,0,0,0,0,0,0
0,0,0,0,0,0,0,0,0,0
0,0,0,0,0,0,0,0,0,0
0,0,0,0,0,0,0,0,0,0
8091,384,297,184,137,80,59,4614,1141,3473
8093,16,13,9,7,6,3,126,54,72
8095,14,11,7,5,5,2,144,44,100
8096,11,12,4,4,2,1,126,34,92
8097,9,7,6,6,2,1,96,31,65
8098,2,3,3,1,1,0,30,10,20
8099,4,4,2,2,0,1,60,13,47
8102,13,13,11,7,4,5,120,53,67
8103,13,13,11,7,4,5,120,53,67
8104,13,16,9,6,5,3,126,52,74
8105,3,6,4,5,3,5,48,26,22
8109,9,9,7,6,4,0,102,35,67
8112,5,2,2,1,0,2,72,12,60
8113,9,7,6,6,4,4,114,36,78
8114,6,6,6,7,3,2,78,30,48
8116,10,10,9,8,4,2,150,43,107
8122,8,8,7,5,4,2,132,34,98
8128,4,8,4,3,1,1,78,21,57
8165,5,4,3,4,2,1,60,19,41
8185,13,14,11,10,6,8,120,62,58
8186,6,5,3,2,1,0,48,17,31
8187,19,12,7,9,6,2,168,55,113
8189,16,16,17,14,10,3,228,76,152
8191,18,22,14,10,3,4,186,71,115
8194,10,7,7,6,2,2,126,34,92
8195,14,15,9,5,5,3,168,51,117
8198,4,4,3,0,0,0,42,11,31
0,0,0,0,0,0,0,0,0,0
8212,6,4,3,3,2,0,54,18,36
0,0,0,0,0,0,0,0,0,0
0,0,0,0,0,0,0,0,0,0
0,0,0,0,0,0,0,0,0,0
0,0,0,0,0,0,0,0,0,0
0,0,0,0,0,0,0,0,0,0
8251,71,64,47,32,23,13,936,250,686
8253,12,12,11,7,6,3,168,51,117
8262,4,4,2,1,1,1,42,13,29
8264,5,7,5,4,2,0,96,23,73
8269,4,3,3,3,1,0,60,14,46
8282,2,2,2,1,1,0,24,8,16
8287,9,11,8,5,2,2,126,37,89
8288,5,7,2,2,1,3,72,20,52
8296,6,7,6,3,2,1,66,25,41
8298,13,12,9,7,6,2,144,49,95
8301,13,11,6,7,1,7,150,45,105
8303,18,18,14,6,6,5,144,67,77
8305,2,3,0,1,0,1,48,7,41
0,0,0,0,0,0,0,0,0,0
0,0,0,0,0,0,0,0,0,0
8316,11,8,7,6,4,1,132,37,95
0,0,0,0,0,0,0,0,0,0
0,0,0,0,0,0,0,0,0,0
8331,10,6,3,2,3,0,102,24,78
8334,9,9,7,4,4,1,90,34,56
8335,107,100,77,70,35,26,1512,415,1097
8337,6,8,7,6,2,3,102,32,70
8339,409,298,201,133,86,53,4248,1180,3068
8342,18,12,11,7,2,2,162,52,110
8343,18,12,11,7,2,2,162,52,110
8348,7,6,4,2,1,0,78,20,58
8352,13,12,7,6,5,4,132,47,85
8353,4,2,1,1,0,0,54,8,46
8354,8,5,3,2,1,2,90,21,69
8356,9,10,5,4,1,1,132,30,102
8357,6,3,2,2,2,1,72,16,56
8360,6,6,5,5,4,2,90,28,62
0,0,0,0,0,0,0,0,0,0
0,0,0,0,0,0,0,0,0,0
0,0,0,0,0,0,0,0,0,0
0,0,0,0,0,0,0,0,0,0
0,0,0,0,0,0,0,0,0,0
8405,17,15,9,4,3,1,216,49,167
8407,7,6,2,2,0,1,60,18,42
8410,13,11,6,3,4,3,126,40,86
8413,18,13,9,8,6,2,180,56,124
8414,2,4,2,2,1,0,78,11,67
8420,7,6,3,3,2,0,108,21,87
8421,6,4,3,2,2,0,78,17,61
8447,9,7,6,6,5,2,102,35,67
8452,499,399,344,217,105,74,6756,1638,5118
8454,3,4,2,1,0,0,48,10,38
8455,4,2,2,1,0,0,48,9,39
8474,2,2,2,2,0,1,24,9,15
8478,8,7,7,6,1,0,102,29,73
8479,279,235,172,113,80,48,3294,927,2367
8482,7,6,4,2,1,1,72,21,51
8483,14,13,10,5,3,3,114,48,66
8487,10,9,6,3,4,4,144,36,108
8488,9,9,11,6,3,2,102,40,62
8489,7,6,4,2,4,3,84,26,58
8491,7,8,3,4,3,3,102,28,74
8492,8,7,6,4,1,2,108,28,80
8493,13,11,12,11,5,3,138,55,83
0,0,0,0,0,0,0,0,0,0
0,0,0,0,0,0,0,0,0,0
0,0,0,0,0,0,0,0,0,0
8518,5,4,2,1,0,0,54,12,42
8525,13,9,7,7,7,0,132,43,89
8526,3,3,2,2,1,1,54,12,42
8527,9,8,7,3,4,3,138,34,104
8530,3,3,3,2,2,0,66,13,53
8537,9,8,5,6,4,1,108,33,75
8538,8,10,4,3,3,1,120,29,91
8543,7,7,4,1,0,3,60,22,38
8553,13,9,7,4,2,2,108,37,71
8557,2,1,1,1,1,0,36,6,30
8574,471,421,335,300,199,71,6390,1797,4593
8583,3,2,2,1,1,0,30,9,21
8586,3,4,2,0,1,0,48,10,38
8587,8,5,5,4,1,2,66,25,41
8588,2,2,2,3,1,2,24,12,12
8589,4,3,2,3,1,2,42,15,27
8595,9,7,4,3,2,2,96,27,69
8597,8,7,7,5,4,2,90,33,57
0,0,0,0,0,0,0,0,0,0
0,0,0,0,0,0,0,0,0,0
0,0,0,0,0,0,0,0,0,0
0,0,0,0,0,0,0,0,0,0
0,0,0,0,0,0,0,0,0,0
8629,4,3,2,2,2,0,78,13,65
8630,7,5,5,6,4,1,84,28,56
8634,9,8,6,3,3,1,102,30,72
0,0,0,0,0,0,0,0,0,0
0,0,0,0,0,0,0,0,0,0
8648,104,94,69,45,37,20,1368,369,999
8652,5,4,2,1,2,1,72,15,57
8655,13,13,7,6,4,2,138,45,93
8660,1,1,1,1,0,0,18,4,14
8664,304,263,243,176,115,45,3924,1146,2778
8666,14,9,8,5,2,0,114,38,76
8667,6,5,6,4,3,1,72,25,47
8668,14,8,6,4,3,3,138,38,100
8673,14,14,10,7,4,1,132,50,82
8675,4,4,3,3,0,1,96,15,81
8693,5,5,6,5,1,1,66,23,43
8709,2,2,0,0,0,0,42,4,38
8711,9,9,6,3,3,2,138,32,106
8712,9,10,8,7,2,1,144,37,107
8713,3,4,3,2,1,2,36,15,21
0,0,0,0,0,0,0,0,0,0
8719,16,10,8,5,3,2,132,44,88
0,0,0,0,0,0,0,0,0,0
0,0,0,0,0,0,0,0,0,0
0,0,0,0,0,0,0,0,0,0
0,0,0,0,0,0,0,0,0,0
0,0,0,0,0,0,0,0,0,0
0,0,0,0,0,0,0,0,0,0
0,0,0,0,0,0,0,0,0,0
0,0,0,0,0,0,0,0,0,0
0,0,0,0,0,0,0,0,0,0
0,0,0,0,0,0,0,0,0,0
0,0,0,0,0,0,0,0,0,0
0,0,0,0,0,0,0,0,0,0
0,0,0,0,0,0,0,0,0,0
8793,10,8,6,5,3,2,90,34,56
8796,17,17,14,13,9,2,168,72,96
8799,226,204,143,112,64,39,2718,788,1930
8802,13,12,8,5,0,4,114,42,72
8806,3,4,2,3,1,1,54,14,40
8807,14,10,5,3,1,3,126,36,90
8825,5,3,4,3,0,2,72,17,55
8826,259,255,199,136,82,56,2976,987,1989
8830,9,11,8,11,6,7,114,52,62
8831,9,11,8,11,6,7,114,52,62
8834,7,7,6,6,3,3,78,32,46
8853,87,66,40,37,29,15,876,274,602
8881,20,16,13,8,5,5,168,67,101
8885,14,9,8,8,5,0,150,44,106
8886,10,8,4,5,3,1,96,31,65
8888,7,4,5,2,0,3,132,21,111
8889,252,214,148,113,73,33,3138,833,2305
8895,13,10,5,2,2,2,132,34,98
8898,9,7,9,5,4,2,90,36,54
8903,818,587,478,304,174,107,9558,2468,7090
8911,14,15,7,6,4,1,138,47,91
8915,11,7,4,3,1,0,108,26,82
8920,159,141,82,65,41,28,2040,516,1524
8924,7,6,4,0,2,1,78,20,58
8925,9,6,4,4,3,1,72,27,45
8934,194,152,95,65,46,22,1986,574,1412
8940,6,11,8,6,4,2,78,37,41
8941,6,11,8,6,4,2,78,37,41
8943,9,9,3,2,1,0,84,24,60
8944,1,0,1,1,0,0,42,3,39
8946,3,3,2,3,2,2,24,15,9
8947,13,5,5,3,2,1,126,29,97
8953,181,164,130,93,53,32,2064,653,1411
0,0,0,0,0,0,0,0,0,0
0,0,0,0,0,0,0,0,0,0
0,0,0,0,0,0,0,0,0,0
0,0,0,0,0,0,0,0,0,0
0,0,0,0,0,0,0,0,0,0
0,0,0,0,0,0,0,0,0,0
0,0,0,0,0,0,0,0,0,0
0,0,0,0,0,0,0,0,0,0
0,0,0,0,0,0,0,0,0,0
0,0,0,0,0,0,0,0,0,0
0,0,0,0,0,0,0,0,0,0
0,0,0,0,0,0,0,0,0,0
9063,7,7,7,6,4,2,90,33,57
9064,5,6,6,3,3,1,90,24,66
9071,4,5,4,3,2,0,84,18,66
9082,6,5,1,2,0,2,90,16,74
9083,4,4,3,1,0,1,78,13,65
9084,10,13,6,3,6,2,120,40,80
9115,8,7,5,7,4,2,90,33,57
9118,15,13,9,8,10,1,186,56,130
9119,6,8,3,3,1,0,78,21,57
9125,10,5,4,4,2,2,108,27,81
9127,18,15,9,7,4,1,168,54,114
9129,6,6,8,5,0,0,96,25,71
9131,9,7,2,2,2,1,72,23,49
9405,59,47,38,20,20,6,702,190,512
9410,11,8,7,5,4,0,102,35,67
9412,7,9,6,4,3,2,96,31,65
9413,5,4,1,0,2,0,72,12,60
0,0,0,0,0,0,0,0,0,0
9438,2,2,1,1,1,0,30,7,23
9439,8,7,4,5,3,0,102,27,75
9455,8,6,6,2,2,1,78,25,53
9456,8,6,6,2,2,1,78,25,53
9463,197,170,136,87,68,31,2280,689,1591
9475,2369,2005,1455,1086,662,419,28026,7996,20030
9487,10,7,5,4,1,3,96,30,66
9501,10,7,10,9,2,1,114,39,75
9502,2,3,3,2,1,0,54,11,43
9503,4,6,5,3,2,2,66,22,44
9504,6,6,6,5,3,3,84,29,55
9512,1941,1821,1280,1017,620,380,23328,7059,16269
9540,11,10,6,5,3,3,90,38,52
9541,8,9,5,2,2,0,90,26,64
9543,480,465,370,265,165,138,6372,1883,4489
9559,4,4,6,5,6,3,60,28,32
9560,6,6,5,3,3,0,114,23,91
9567,7,8,2,4,1,4,84,26,58
9569,5,6,3,3,2,2,84,21,63
9570,6,6,4,0,0,1,108,17,91
9572,10,11,13,8,3,5,132,50,82
9573,8,10,7,6,0,6,126,37,89
9574,5,4,2,1,1,0,54,13,41
9586,368,275,196,131,99,50,4188,1119,3069
9596,7,6,5,1,2,0,102,21,81
9598,11,7,7,4,3,2,126,34,92
9602,408,356,277,209,132,59,4956,1441,3515
9627,7,5,5,3,3,1,96,24,72
9630,11,12,9,11,7,2,138,52,86
9632,14,12,5,4,2,2,138,39,99
9643,9,8,5,5,3,1,84,31,53
9649,5,6,4,4,3,1,66,23,43
0,0,0,0,0,0,0,0,0,0
0,0,0,0,0,0,0,0,0,0
0,0,0,0,0,0,0,0,0,0
0,0,0,0,0,0,0,0,0,0
0,0,0,0,0,0,0,0,0,0
0,0,0,0,0,0,0,0,0,0
0,0,0,0,0,0,0,0,0,0
9718,4,4,3,1,1,2,66,15,51
9723,6,7,4,5,4,2,102,28,74
9724,11,10,10,7,5,3,132,46,86
9732,13,13,13,9,6,6,138,60,78
9739,4,4,2,1,0,2,42,13,29
9741,190,155,128,90,58,19,2010,640,1370
9745,9,12,9,5,5,2,126,42,84
9746,18,16,12,6,5,3,144,60,84
9747,12,14,10,6,8,4,144,54,90
9748,6,7,2,2,3,2,84,22,62
9754,9,10,6,6,3,2,114,36,78
9755,14,14,8,5,3,3,156,47,109
9756,8,9,7,4,1,0,102,29,73
9854,5,3,3,2,2,1,60,16,44
9857,19,20,11,4,7,1,174,62,112
9858,19,20,11,4,7,1,174,62,112
9860,8,7,5,4,4,3,96,31,65
9861,2,1,1,1,0,1,48,6,42
9862,5,3,1,1,0,2,54,12,42
9863,8,6,7,4,2,2,96,29,67
9896,7,8,5,4,1,3,90,28,62
9897,7,8,5,4,1,3,90,28,62
9910,4,3,2,1,1,0,72,11,61
9914,4,5,3,3,1,1,48,17,31
9919,5,7,5,4,1,2,48,24,24
9923,13,12,6,5,2,2,138,40,98
9924,14,14,7,5,2,1,138,43,95
9925,9,10,8,4,3,1,132,35,97
9926,3,5,2,2,1,1,78,14,64
9927,6,7,6,5,2,0,78,26,52
9928,8,7,8,6,5,3,114,37,77
9930,202,159,80,78,26,41,3018,586,2432
0,0,0,0,0,0,0,0,0,0
9942,140,136,89,68,33,36,1542,502,1040
9952,11,11,4,2,1,1,96,30,66
9954,10,8,6,6,2,4,102,36,66
9957,10,7,7,5,2,2,96,33,63
9963,67,66,42,28,19,14,780,236,544
9973,4,3,2,3,1,0,48,13,35
9986,1998,1539,1132,752,424,281,21750,6126,15624
9996,7,6,3,3,4,3,96,26,70
9997,1,1,0,0,0,0,60,2,58
9998,15,10,7,5,4,3,174,44,130
9999,15,10,7,5,4,3,174,44,130
10000,10,11,6,7,4,4,126,42,84
10002,19,18,12,9,8,1,162,67,95
10005,11,10,8,5,4,2,114,40,74
10006,11,10,8,5,4,2,114,40,74
10012,9,8,4,3,1,1,96,26,70
10013,7,7,8,5,2,1,102,30,72
10017,3,2,3,2,0,2,66,12,54
10018,7,8,7,5,5,1,108,33,75
10038,7,7,8,5,2,1,102,30,72
10040,5,6,5,5,2,2,108,25,83
10041,7,7,5,5,0,1,60,25,35
10042,3,5,5,2,0,1,54,16,38
10043,10,8,3,3,1,0,114,25,89
10044,15,14,12,10,8,4,156,63,93
10045,7,5,3,3,3,1,84,22,62
10046,7,5,3,3,3,1,84,22,62
10059,9,4,5,5,4,0,96,27,69
10060,5,4,6,2,3,1,48,21,27
0,0,0,0,0,0,0,0,0,0
0,0,0,0,0,0,0,0,0,0
0,0,0,0,0,0,0,0,0,0
0,0,0,0,0,0,0,0,0,0
0,0,0,0,0,0,0,0,0,0
0,0,0,0,0,0,0,0,0,0
0,0,0,0,0,0,0,0,0,0
0,0,0,0,0,0,0,0,0,0
0,0,0,0,0,0,0,0,0,0
0,0,0,0,0,0,0,0,0,0
0,0,0,0,0,0,0,0,0,0
0,0,0,0,0,0,0,0,0,0
0,0,0,0,0,0,0,0,0,0
10141,16,12,7,6,4,3,162,48,114
10143,16,12,7,6,4,3,162,48,114
10144,6,4,3,1,0,1,54,15,39
10159,12,12,7,5,4,2,132,42,90
0,0,0,0,0,0,0,0,0,0
0,0,0,0,0,0,0,0,0,0
0,0,0,0,0,0,0,0,0,0
10170,14,14,1,5,5,0,138,39,99
10178,8,7,6,4,1,1,126,27,99
10179,7,5,6,5,2,1,60,26,34
10184,2,3,1,0,0,1,48,7,41
10185,4,4,3,2,3,0,54,16,38
10189,8,8,4,1,2,2,90,25,65
10190,8,4,5,3,1,0,90,21,69
10192,14,9,5,1,3,0,114,32,82
10195,3,7,6,4,2,3,54,25,29
10196,5,5,4,2,1,1,84,18,66
10210,8,6,3,1,0,2,60,20,40
10229,10,5,5,3,3,1,144,27,117
10231,19,19,14,9,9,4,162,74,88
10233,9,6,5,4,3,1,114,28,86
10235,6,6,4,3,2,1,108,22,86
10239,12,14,9,7,5,1,150,48,102
10240,6,7,6,8,4,2,114,33,81
0,0,0,0,0,0,0,0,0,0
0,0,0,0,0,0,0,0,0,0
0,0,0,0,0,0,0,0,0,0
10263,1,1,1,0,0,0,24,3,21
10264,12,7,8,5,5,2,96,39,57
10268,4,2,2,1,0,0,54,9,45
10269,8,9,7,6,5,1,120,36,84
10277,7,6,5,3,2,1,90,24,66
10278,60,53,34,23,21,7,654,198,456
10286,11,6,5,3,3,0,96,28,68
10287,8,3,2,1,1,2,90,17,73
10313,1768,1435,1163,780,566,261,20718,5973,14745
10326,4,1,1,1,0,1,42,8,34
0,0,0,0,0,0,0,0,0,0
10328,11,7,1,1,1,0,96,21,75
0,0,0,0,0,0,0,0,0,0
10330,3,3,2,3,1,3,90,15,75
10331,3,3,2,3,1,3,90,15,75
10347,75,63,47,37,23,11,984,256,728
10349,7,6,4,3,3,2,54,25,29
10358,16,15,10,7,5,2,144,55,89
10359,8,9,9,4,0,0,114,30,84
0,0,0,0,0,0,0,0,0,0
10371,11,9,6,4,4,2,144,36,108
10372,11,9,6,4,4,2,144,36,108
10373,8,5,2,3,3,0,126,21,105
10378,9,8,7,5,3,2,84,34,50
10379,11,12,7,7,6,3,108,46,62
10381,5,5,6,2,2,2,84,22,62
10382,4,5,2,1,1,0,60,13,47
10392,1188,1058,761,588,373,174,16602,4142,12460
0,0,0,0,0,0,0,0,0,0
10422,7,10,10,8,5,2,102,42,60
10423,10,12,11,10,6,1,132,50,82
10424,8,11,5,5,4,1,120,34,86
10426,6,7,7,4,3,2,84,29,55
0,0,0,0,0,0,0,0,0,0
10441,14,12,7,4,3,3,156,43,113
10442,9,6,3,1,1,1,78,21,57
0,0,0,0,0,0,0,0,0,0
0,0,0,0,0,0,0,0,0,0
10485,8,10,6,4,4,2,90,34,56
10490,3,3,0,2,1,0,36,9,27
10491,6,6,5,3,3,2,84,25,59
10492,4,6,5,2,1,1,72,19,53
10493,1443,1269,945,679,456,213,16668,5005,11663
10514,399,335,274,196,135,78,4938,1417,3521
10517,5,3,4,2,1,0,60,15,45
10519,5,5,5,6,1,2,108,24,84
10520,5,4,5,4,3,1,60,22,38
10526,15,12,13,10,9,3,132,62,70
10527,15,12,13,10,9,3,132,62,70
10529,12,6,5,5,4,2,114,34,80
10534,4,4,1,1,1,0,42,11,31
10545,10,9,7,2,0,2,138,30,108
10548,7,4,4,4,2,1,114,22,92
10552,9,5,5,3,3,1,102,26,76
10553,10,9,7,4,4,2,96,36,60
10559,3,3,1,1,1,0,30,9,21
10578,5,4,3,3,1,3,72,19,53
10608,2,1,2,1,1,1,30,8,22
10609,15,13,9,10,5,0,120,52,68
10610,15,13,9,10,5,0,120,52,68
10611,5,4,5,4,3,1,48,22,26
10612,12,11,5,5,1,3,120,37,83
10613,17,15,12,6,2,5,162,57,105
10614,17,15,12,6,2,5,162,57,105
10619,4,4,3,2,1,1,60,15,45
10622,8,6,3,4,3,0,108,24,84
10625,4,6,4,4,2,1,66,21,45
10628,14,10,9,8,5,3,138,49,89
10629,10,8,5,2,2,1,84,28,56
10631,9,6,7,5,1,1,78,29,49
10632,11,9,9,4,5,1,96,39,57
10633,10,11,7,4,5,1,102,38,64
10635,7,7,4,3,4,0,72,25,47
10636,139,120,90,63,38,41,1380,491,889
10638,4,4,1,1,1,0,54,11,43
10639,5,5,3,2,1,2,42,18,24
10640,8,7,6,3,1,2,72,27,45
0,0,0,0,0,0,0,0,0,0
0,0,0,0,0,0,0,0,0,0
0,0,0,0,0,0,0,0,0,0
0,0,0,0,0,0,0,0,0,0
0,0,0,0,0,0,0,0,0,0
0,0,0,0,0,0,0,0,0,0
0,0,0,0,0,0,0,0,0,0
0,0,0,0,0,0,0,0,0,0
0,0,0,0,0,0,0,0,0,0
10675,233,203,131,82,38,29,2538,716,1822
0,0,0,0,0,0,0,0,0,0
0,0,0,0,0,0,0,0,0,0
0,0,0,0,0,0,0,0,0,0
0,0,0,0,0,0,0,0,0,0
0,0,0,0,0,0,0,0,0,0
0,0,0,0,0,0,0,0,0,0
10838,9,10,8,3,1,2,138,33,105
10839,9,10,8,3,1,2,138,33,105
10840,7,8,7,4,3,2,102,31,71
0,0,0,0,0,0,0,0,0,0
10862,20,24,23,19,11,7,294,104,190
10867,7,6,4,4,2,1,78,24,54
10868,5,6,6,4,4,2,72,27,45
10869,3,5,2,1,1,2,54,14,40
10883,3,3,5,2,2,0,66,15,51
10884,5,7,6,6,3,1,78,28,50
10901,2,3,3,2,0,1,36,11,25
0,0,0,0,0,0,0,0,0,0
10915,5,4,1,1,1,0,60,12,48
0,0,0,0,0,0,0,0,0,0
0,0,0,0,0,0,0,0,0,0
0,0,0,0,0,0,0,0,0,0
0,0,0,0,0,0,0,0,0,0
0,0,0,0,0,0,0,0,0,0
0,0,0,0,0,0,0,0,0,0
10971,11,7,5,4,0,2,144,29,115
10978,6,7,4,2,2,0,90,21,69
10988,10,8,7,3,4,1,84,33,51
10990,7,4,2,2,0,0,60,15,45
10991,14,11,10,5,1,1,150,42,108
10992,9,11,3,4,3,3,132,33,99
10993,9,11,3,4,3,3,132,33,99
10994,7,9,4,4,1,3,114,28,86
0,0,0,0,0,0,0,0,0,0
11025,6,7,4,5,3,1,84,26,58
11048,13,9,9,9,5,4,114,49,65
11049,13,9,9,9,5,4,114,49,65
11054,12,11,9,5,3,1,108,41,67
11055,4,6,4,5,3,2,42,24,18
11057,248,160,113,90,41,32,2712,684,2028
11059,663,589,393,299,168,102,8280,2214,6066
11061,75,52,48,31,18,8,816,232,584
11065,18,17,15,11,8,3,168,72,96
11067,9,10,4,4,2,0,78,29,49
11069,14,11,4,2,1,2,138,34,104
11070,14,11,4,2,1,2,138,34,104
11071,17,13,6,2,2,4,132,44,88
11073,17,19,17,11,6,5,168,75,93
0,0,0,0,0,0,0,0,0,0
11108,8,6,4,2,0,0,48,20,28
11109,0,2,2,2,1,2,30,9,21
11110,3,2,1,1,0,0,30,7,23
11111,2,2,1,2,1,1,24,9,15
0,0,0,0,0,0,0,0,0,0
0,0,0,0,0,0,0,0,0,0
0,0,0,0,0,0,0,0,0,0
0,0,0,0,0,0,0,0,0,0
11130,5,1,2,2,1,0,42,11,31
11131,9,7,5,4,2,2,90,29,61
11132,18,14,9,5,0,4,120,50,70
11135,5,6,5,6,3,1,54,26,28
11173,10,9,8,6,2,1,90,36,54
11181,4,5,4,4,2,5,42,24,18
11192,11,15,9,8,6,5,120,54,66
11198,7,7,4,4,2,1,96,25,71
0,0,0,0,0,0,0,0,0,0
0,0,0,0,0,0,0,0,0,0
0,0,0,0,0,0,0,0,0,0
0,0,0,0,0,0,0,0,0,0
0,0,0,0,0,0,0,0,0,0
0,0,0,0,0,0,0,0,0,0
0,0,0,0,0,0,0,0,0,0
0,0,0,0,0,0,0,0,0,0
0,0,0,0,0,0,0,0,0,0
0,0,0,0,0,0,0,0,0,0
0,0,0,0,0,0,0,0,0,0
11259,55,54,40,29,19,13,792,210,582
0,0,0,0,0,0,0,0,0,0
0,0,0,0,0,0,0,0,0,0
0,0,0,0,0,0,0,0,0,0
0,0,0,0,0,0,0,0,0,0
0,0,0,0,0,0,0,0,0,0
11297,14,13,10,9,3,2,150,51,99
11299,9,9,5,3,2,2,78,30,48
11300,1,1,2,1,1,0,30,6,24
0,0,0,0,0,0,0,0,0,0
0,0,0,0,0,0,0,0,0,0
11318,1425,1221,886,659,372,240,17250,4803,12447
11337,3,4,4,2,1,0,66,14,52
11338,10,7,7,5,6,1,114,36,78
11356,13,11,7,5,4,5,132,45,87
0,0,0,0,0,0,0,0,0,0
0,0,0,0,0,0,0,0,0,0
0,0,0,0,0,0,0,0,0,0
11376,4,3,2,2,2,2,42,15,27
11377,2,3,3,2,1,2,36,13,23
11378,5,3,2,2,3,0,30,15,15
11379,2,1,1,2,1,0,36,7,29
0,0,0,0,0,0,0,0,0,0
11408,7,7,6,3,2,2,72,27,45
11409,7,7,6,3,2,2,72,27,45
11410,11,12,6,5,3,5,114,42,72
11413,2,2,2,0,1,1,42,8,34
11414,135,134,85,64,40,26,1680,484,1196
0,0,0,0,0,0,0,0,0,0
0,0,0,0,0,0,0,0,0,0
11439,5,7,3,4,2,1,66,22,44
0,0,0,0,0,0,0,0,0,0
0,0,0,0,0,0,0,0,0,0
0,0,0,0,0,0,0,0,0,0
0,0,0,0,0,0,0,0,0,0
0,0,0,0,0,0,0,0,0,0
11487,7,5,4,5,3,1,66,25,41
0,0,0,0,0,0,0,0,0,0
11489,9,6,4,3,3,0,84,25,59
0,0,0,0,0,0,0,0,0,0
0,0,0,0,0,0,0,0,0,0
0,0,0,0,0,0,0,0,0,0
11502,154,132,89,62,43,23,1614,503,1111
0,0,0,0,0,0,0,0,0,0
0,0,0,0,0,0,0,0,0,0
0,0,0,0,0,0,0,0,0,0
11514,2,1,2,2,0,1,24,8,16
11515,4,2,2,1,2,2,48,13,35
11520,1,1,0,0,0,0,18,2,16
11527,4,4,2,1,1,0,66,12,54
11528,2,2,2,3,0,1,42,10,32
0,0,0,0,0,0,0,0,0,0
11545,157,177,151,80,84,60,2004,709,1295
0,0,0,0,0,0,0,0,0,0
0,0,0,0,0,0,0,0,0,0
11581,4,3,2,2,1,1,42,13,29
11606,15,13,10,6,3,3,138,50,88
0,0,0,0,0,0,0,0,0,0
0,0,0,0,0,0,0,0,0,0
0,0,0,0,0,0,0,0,0,0
0,0,0,0,0,0,0,0,0,0
0,0,0,0,0,0,0,0,0,0
11635,11,9,5,5,5,0,102,35,67
11646,179,169,128,94,47,35,2352,652,1700
11650,4,2,1,0,1,0,36,8,28
11651,7,8,3,5,1,2,96,26,70
11652,5,5,1,1,0,1,54,13,41
11661,6,4,2,1,2,0,84,15,69
11662,6,4,2,1,2,0,84,15,69
11664,2,3,2,2,1,1,54,11,43
0,0,0,0,0,0,0,0,0,0
0,0,0,0,0,0,0,0,0,0
0,0,0,0,0,0,0,0,0,0
0,0,0,0,0,0,0,0,0,0
11677,321,220,161,102,62,36,3132,902,2230
11683,6,8,4,4,2,2,60,26,34
11684,5,5,0,2,0,0,78,12,66
11685,11,15,10,6,3,4,150,49,101
11686,9,5,2,3,1,1,84,21,63
11687,8,8,6,6,6,1,84,35,49
11690,1,3,2,2,2,0,36,10,26
11691,4,6,5,5,2,3,78,25,53
11692,4,4,3,3,1,0,42,15,27
11693,5,5,6,4,3,1,60,24,36
0,0,0,0,0,0,0,0,0,0
12423,127,95,59,48,27,12,1494,368,1126
0,0,0,0,0,0,0,0,0,0
0,0,0,0,0,0,0,0,0,0
0,0,0,0,0,0,0,0,0,0
11734,8,8,4,4,4,1,96,29,67
11735,2,0,1,1,1,0,18,5,13
11736,9,10,7,6,2,2,90,36,54
11739,2,3,2,2,1,1,24,11,13
11776,3,3,3,1,1,2,54,13,41
11778,6,4,2,3,1,2,48,18,30
0,0,0,0,0,0,0,0,0,0
0,0,0,0,0,0,0,0,0,0
11796,4,3,6,2,1,1,66,17,49
11799,8,9,7,6,3,1,90,34,56
0,0,0,0,0,0,0,0,0,0
0,0,0,0,0,0,0,0,0,0
0,0,0,0,0,0,0,0,0,0
0,0,0,0,0,0,0,0,0,0
11828,3,5,5,3,1,1,60,18,42
11829,8,5,7,6,1,4,84,31,53
11830,3,4,2,3,0,1,42,13,29
11831,11,9,5,6,6,1,126,38,88
11834,6,5,6,3,1,3,78,24,54
11835,9,7,5,3,4,1,102,29,73
0,0,0,0,0,0,0,0,0,0
0,0,0,0,0,0,0,0,0,0
11851,13,11,8,5,3,1,138,41,97
11852,8,5,4,2,1,2,108,22,86
0,0,0,0,0,0,0,0,0,0
0,0,0,0,0,0,0,0,0,0
11871,8,11,6,4,5,6,108,40,68
11872,9,11,8,7,5,0,120,40,80
11876,5,5,5,2,0,2,78,19,59
11878,5,5,4,3,2,2,114,21,93
0,0,0,0,0,0,0,0,0,0
0,0,0,0,0,0,0,0,0,0
0,0,0,0,0,0,0,0,0,0
0,0,0,0,0,0,0,0,0,0
0,0,0,0,0,0,0,0,0,0
0,0,0,0,0,0,0,0,0,0
0,0,0,0,0,0,0,0,0,0
11911,1202,958,711,464,283,179,13674,3797,9877
11915,2059,1517,1026,741,450,254,22710,6047,16663
11919,6,7,4,2,1,1,72,21,51
11920,6,4,1,2,0,2,48,15,33
0,0,0,0,0,0,0,0,0,0
0,0,0,0,0,0,0,0,0,0
0,0,0,0,0,0,0,0,0,0
0,0,0,0,0,0,0,0,0,0
0,0,0,0,0,0,0,0,0,0
0,0,0,0,0,0,0,0,0,0
0,0,0,0,0,0,0,0,0,0
0,0,0,0,0,0,0,0,0,0
0,0,0,0,0,0,0,0,0,0
0,0,0,0,0,0,0,0,0,0
0,0,0,0,0,0,0,0,0,0
0,0,0,0,0,0,0,0,0,0
0,0,0,0,0,0,0,0,0,0
0,0,0,0,0,0,0,0,0,0
0,0,0,0,0,0,0,0,0,0
0,0,0,0,0,0,0,0,0,0
0,0,0,0,0,0,0,0,0,0
12051,149,115,73,42,23,23,1416,425,991
12055,9,9,8,6,3,3,108,38,70
12056,7,4,5,4,1,2,84,23,61
12058,2,2,0,0,0,0,36,4,32
0,0,0,0,0,0,0,0,0,0
0,0,0,0,0,0,0,0,0,0
0,0,0,0,0,0,0,0,0,0
0,0,0,0,0,0,0,0,0,0
0,0,0,0,0,0,0,0,0,0
12077,7,6,4,2,1,0,54,20,34
0,0,0,0,0,0,0,0,0,0
12080,3,1,1,0,1,0,24,6,18
0,0,0,0,0,0,0,0,0,0
0,0,0,0,0,0,0,0,0,0
0,0,0,0,0,0,0,0,0,0
0,0,0,0,0,0,0,0,0,0
0,0,0,0,0,0,0,0,0,0
0,0,0,0,0,0,0,0,0,0
0,0,0,0,0,0,0,0,0,0
0,0,0,0,0,0,0,0,0,0
0,0,0,0,0,0,0,0,0,0
0,0,0,0,0,0,0,0,0,0
0,0,0,0,0,0,0,0,0,0
0,0,0,0,0,0,0,0,0,0
0,0,0,0,0,0,0,0,0,0
0,0,0,0,0,0,0,0,0,0
0,0,0,0,0,0,0,0,0,0
12130,11,7,5,3,2,0,90,28,62
12131,6,7,8,6,4,0,78,31,47
12133,4,4,1,3,3,3,54,18,36
12136,7,7,7,2,1,2,114,26,88
0,0,0,0,0,0,0,0,0,0
0,0,0,0,0,0,0,0,0,0
0,0,0,0,0,0,0,0,0,0
12147,199,158,117,90,48,28,2424,640,1784
12150,39,41,22,18,10,8,534,138,396
12154,9,7,6,4,2,4,96,32,64
12155,8,7,4,2,1,1,78,23,55
12157,18,15,9,7,3,3,156,55,101
12159,10,10,6,6,3,3,84,38,46
0,0,0,0,0,0,0,0,0,0
0,0,0,0,0,0,0,0,0,0
0,0,0,0,0,0,0,0,0,0
12226,36,32,16,14,9,5,408,112,296
0,0,0,0,0,0,0,0,0,0
0,0,0,0,0,0,0,0,0,0
0,0,0,0,0,0,0,0,0,0
0,0,0,0,0,0,0,0,0,0
0,0,0,0,0,0,0,0,0,0
12258,1459,1306,1049,856,543,207,17934,5420,12514
0,0,0,0,0,0,0,0,0,0
12265,6,3,4,2,1,1,78,17,61
12266,15,15,7,2,3,1,132,43,89
12268,8,3,4,3,2,2,60,22,38
0,0,0,0,0,0,0,0,0,0
12277,17,14,9,6,6,1,120,53,67
12279,8,8,2,3,1,3,90,25,65
12280,8,14,6,5,5,2,120,40,80
12281,5,8,5,4,2,4,72,28,44
0,0,0,0,0,0,0,0,0,0
0,0,0,0,0,0,0,0,0,0
0,0,0,0,0,0,0,0,0,0
12346,2,2,1,1,0,2,30,8,22
12347,8,7,5,6,3,3,84,32,52
12348,14,11,9,7,5,2,120,48,72
12353,8,7,2,1,1,2,66,21,45
12359,150,108,72,40,19,22,1416,411,1005
12361,6,6,6,5,5,2,60,30,30
12362,7,7,5,1,0,0,96,20,76
12363,16,16,11,5,3,1,150,52,98
12365,10,7,6,3,1,0,108,27,81
12366,11,9,8,4,2,2,126,36,90
12367,5,6,5,6,2,1,66,25,41
0,0,0,0,0,0,0,0,0,0
0,0,0,0,0,0,0,0,0,0
0,0,0,0,0,0,0,0,0,0
12404,94,76,69,40,20,15,1200,314,886
12406,8,7,7,7,4,4,120,37,83
0,0,0,0,0,0,0,0,0,0
0,0,0,0,0,0,0,0,0,0
12429,5,6,4,3,4,0,84,22,62
12430,2,0,1,1,0,1,36,5,31
12431,2,1,1,1,0,0,24,5,19
12439,7,4,2,2,0,1,72,16,56
12440,13,10,8,3,0,2,114,36,78
12442,11,13,11,8,7,1,150,51,99
0,0,0,0,0,0,0,0,0,0
0,0,0,0,0,0,0,0,0,0
12464,13,16,10,5,6,4,150,54,96
12465,8,8,3,1,1,3,90,24,66
12470,7,6,4,4,2,3,102,26,76
12471,6,9,5,3,3,0,102,26,76
0,0,0,0,0,0,0,0,0,0
0,0,0,0,0,0,0,0,0,0
0,0,0,0,0,0,0,0,0,0
0,0,0,0,0,0,0,0,0,0
12932,166,171,122,105,55,45,1752,664,1088
12489,146,141,88,68,41,38,1758,522,1236
0,0,0,0,0,0,0,0,0,0
0,0,0,0,0,0,0,0,0,0
0,0,0,0,0,0,0,0,0,0
0,0,0,0,0,0,0,0,0,0
12502,11,9,9,7,5,3,96,44,52
12503,7,4,3,1,2,3,66,20,46
12506,7,8,5,7,5,2,78,34,44
12507,10,9,7,5,3,1,114,35,79
12508,12,7,8,6,2,1,114,36,78
12548,289,170,133,73,28,13,3504,706,2798
0,0,0,0,0,0,0,0,0,0
12554,13,11,8,7,3,1,126,43,83
12555,13,11,8,7,3,1,126,43,83
0,0,0,0,0,0,0,0,0,0
0,0,0,0,0,0,0,0,0,0
12566,81,61,44,34,23,11,1206,254,952
0,0,0,0,0,0,0,0,0,0
0,0,0,0,0,0,0,0,0,0
0,0,0,0,0,0,0,0,0,0
12581,7,6,3,4,2,2,84,24,60
12582,7,6,3,3,1,2,60,22,38
12583,4,3,2,3,1,2,48,15,33
12584,3,3,4,2,1,1,48,14,34
12585,10,8,3,2,2,1,96,26,70
12629,8,8,4,5,1,3,108,29,79
12630,6,8,6,6,2,1,114,29,85
12632,16,17,11,10,7,4,156,65,91
0,0,0,0,0,0,0,0,0,0
0,0,0,0,0,0,0,0,0,0
0,0,0,0,0,0,0,0,0,0
0,0,0,0,0,0,0,0,0,0
12651,1570,1434,1034,799,559,283,18030,5679,12351
12663,149,135,105,62,39,28,1524,518,1006
12678,3,4,1,1,1,1,36,11,25
0,0,0,0,0,0,0,0,0,0
12685,12,8,6,5,2,3,120,36,84
12687,5,3,2,1,1,0,60,12,48
12688,10,10,4,5,3,0,120,32,88
12689,17,16,13,11,6,7,174,70,104
12690,17,16,13,11,6,7,174,70,104
0,0,0,0,0,0,0,0,0,0
0,0,0,0,0,0,0,0,0,0
0,0,0,0,0,0,0,0,0,0
12703,272,172,133,70,49,22,2598,718,1880
0,0,0,0,0,0,0,0,0,0
0,0,0,0,0,0,0,0,0,0
0,0,0,0,0,0,0,0,0,0
0,0,0,0,0,0,0,0,0,0
0,0,0,0,0,0,0,0,0,0
0,0,0,0,0,0,0,0,0,0
0,0,0,0,0,0,0,0,0,0
12733,5,3,3,2,2,0,36,15,21
12751,6,8,6,6,2,3,120,31,89
12752,6,8,6,6,2,3,120,31,89
12753,10,10,8,6,5,4,108,43,65
12754,14,13,7,7,5,2,156,48,108
12756,12,11,13,7,4,7,126,54,72
12758,14,14,8,6,4,1,162,47,115
12759,11,11,8,7,6,2,120,45,75
12760,9,9,3,2,2,1,114,26,88
12762,6,6,8,4,1,2,90,27,63
12763,4,2,3,1,3,1,60,14,46
12768,5,6,6,5,2,1,66,25,41
0,0,0,0,0,0,0,0,0,0
12780,1406,1107,738,568,325,232,15888,4376,11512
12805,6,10,5,4,2,2,132,29,103
12808,10,8,5,8,7,1,102,39,63
0,0,0,0,0,0,0,0,0,0
0,0,0,0,0,0,0,0,0,0
12857,9,7,8,2,3,0,114,29,85
12860,4,2,2,3,2,1,36,14,22
0,0,0,0,0,0,0,0,0,0
0,0,0,0,0,0,0,0,0,0
0,0,0,0,0,0,0,0,0,0
12872,10,9,8,4,2,7,126,40,86
12873,10,9,8,4,2,7,126,40,86
12876,13,11,11,8,4,3,156,50,106
0,0,0,0,0,0,0,0,0,0
12890,1544,1338,1048,752,512,249,16776,5443,11333
12914,12,12,7,7,7,2,126,47,79
12915,11,8,6,5,3,2,144,35,109
0,0,0,0,0,0,0,0,0,0
0,0,0,0,0,0,0,0,0,0
0,0,0,0,0,0,0,0,0,0
12928,4,2,4,2,1,0,66,13,53
12934,269,234,157,103,61,38,3108,862,2246
12936,5,7,3,5,0,3,78,23,55
12938,5,5,3,1,0,1,42,15,27
12940,4,3,2,1,1,0,54,11,43
0,0,0,0,0,0,0,0,0,0
12958,557,458,346,271,174,84,6558,1890,4668
0,0,0,0,0,0,0,0,0,0
0,0,0,0,0,0,0,0,0,0
12966,5,4,3,1,2,1,48,16,32
0,0,0,0,0,0,0,0,0,0
12971,1439,1120,783,515,304,219,15402,4380,11022
12990,9,8,3,2,2,1,78,25,53
12991,5,4,4,2,0,0,54,15,39
12993,10,9,7,6,5,6,108,43,65
0,0,0,0,0,0,0,0,0,0
0,0,0,0,0,0,0,0,0,0
13006,3,1,1,1,0,0,42,6,36
0,0,0,0,0,0,0,0,0,0
0,0,0,0,0,0,0,0,0,0
13023,3,1,2,1,1,0,42,8,34
0,0,0,0,0,0,0,0,0,0
0,0,0,0,0,0,0,0,0,0
13030,9,8,7,5,2,3,162,34,128
13033,9,4,4,1,1,1,96,20,76
13034,13,9,5,5,0,3,144,35,109
13035,12,10,5,2,3,1,108,33,75
13036,42,34,38,26,18,24,672,182,490
0,0,0,0,0,0,0,0,0,0
13078,8,8,6,10,2,2,120,36,84
13079,12,11,7,5,3,2,120,40,80
13082,6,6,7,6,4,0,102,29,73
13083,8,9,6,6,4,2,114,35,79
13085,10,11,5,5,3,0,126,34,92
0,0,0,0,0,0,0,0,0,0
13098,173,164,121,88,58,39,2472,643,1829
0,0,0,0,0,0,0,0,0,0
0,0,0,0,0,0,0,0,0,0
0,0,0,0,0,0,0,0,0,0
13132,1469,1198,864,624,418,229,15906,4802,11104
13139,12,10,6,5,2,3,108,38,70
13140,5,4,5,2,1,2,72,19,53
13146,13,9,6,2,1,1,138,32,106
13148,6,9,10,7,4,0,138,36,102
13151,52,58,30,30,18,11,612,199,413
13155,1,2,2,2,1,0,24,8,16
0,0,0,0,0,0,0,0,0,0
0,0,0,0,0,0,0,0,0,0
13162,13,10,8,4,2,3,138,40,98
13165,5,3,4,2,3,2,66,19,47
0,0,0,0,0,0,0,0,0,0
0,0,0,0,0,0,0,0,0,0
0,0,0,0,0,0,0,0,0,0
0,0,0,0,0,0,0,0,0,0
13215,8,8,5,4,3,3,120,31,89
13216,7,8,6,6,4,1,108,32,76
13217,3,3,2,2,2,0,48,12,36
13218,8,9,3,7,3,1,114,31,83
13227,4,2,0,0,0,0,72,6,66
13243,10,11,5,2,1,2,96,31,65
13251,4,4,2,2,1,2,66,15,51
13252,4,4,2,2,1,2,66,15,51
13255,1,2,2,1,0,2,36,8,28
13260,12,12,8,6,7,2,114,47,67
0,0,0,0,0,0,0,0,0,0
0,0,0,0,0,0,0,0,0,0
0,0,0,0,0,0,0,0,0,0
13274,13,9,7,5,0,1,120,35,85
13275,5,5,3,2,1,0,66,16,50
13276,4,5,6,2,2,1,72,20,52
13278,5,6,4,2,1,1,72,19,53
13279,7,8,7,3,1,1,102,27,75
13280,7,7,2,1,1,2,96,20,76
13281,9,9,6,6,3,1,102,34,68
0,0,0,0,0,0,0,0,0,0
13288,49,38,13,15,13,4,558,132,426
0,0,0,0,0,0,0,0,0,0
0,0,0,0,0,0,0,0,0,0
13339,15,14,6,5,3,1,156,44,112
13340,9,9,5,4,2,0,66,29,37
13341,18,18,8,6,6,0,156,56,100
13359,11,5,6,3,3,3,114,31,83
0,0,0,0,0,0,0,0,0,0
13364,14,12,8,6,1,4,114,45,69
13365,8,6,9,6,6,3,138,38,100
13367,84,71,49,33,25,24,1140,286,854
13372,8,9,8,7,5,2,114,39,75
13373,8,9,8,7,5,2,114,39,75
13374,2,3,2,2,2,1,48,12,36
13375,4,6,3,2,1,1,54,17,37
13376,8,7,4,3,2,2,90,26,64
13377,8,6,2,1,1,1,72,19,53
0,0,0,0,0,0,0,0,0,0
0,0,0,0,0,0,0,0,0,0
13398,8,5,4,4,1,0,90,22,68
13402,4,6,5,4,1,4,60,24,36
13408,5,5,5,4,4,0,84,23,61
0,0,0,0,0,0,0,0,0,0
13414,5,5,3,2,1,1,72,17,55
13415,10,7,4,4,2,3,108,30,78
13416,9,8,6,5,4,2,90,34,56
13417,3,4,3,2,0,1,36,13,23
0,0,0,0,0,0,0,0,0,0
13441,11,10,9,5,3,1,102,39,63
13445,6,8,9,7,6,3,120,39,81
13446,5,5,1,0,1,0,60,12,48
13447,5,6,4,3,1,1,78,20,58
13478,4,4,1,0,0,1,36,10,26
13479,4,3,1,1,1,0,48,10,38
13480,4,2,1,1,0,0,36,8,28
0,0,0,0,0,0,0,0,0,0
0,0,0,0,0,0,0,0,0,0
13489,7,2,2,2,1,1,48,15,33
13490,11,7,7,4,4,1,102,34,68
13491,2,3,3,1,1,1,36,11,25
13493,9,8,4,4,2,1,72,28,44
13494,2,2,2,1,0,1,30,8,22
13496,1,2,3,2,0,0,36,8,28
0,0,0,0,0,0,0,0,0,0
0,0,0,0,0,0,0,0,0,0
0,0,0,0,0,0,0,0,0,0
13515,166,102,87,59,32,23,1758,469,1289
13521,7,5,2,4,4,0,78,22,56
13522,9,8,3,2,1,2,108,25,83
0,0,0,0,0,0,0,0,0,0
0,0,0,0,0,0,0,0,0,0
0,0,0,0,0,0,0,0,0,0
13538,11,8,6,5,2,2,96,34,62
13539,11,6,4,3,2,1,78,27,51
13540,20,9,15,7,4,1,156,56,100
13542,10,9,7,5,3,3,90,37,53
13543,10,9,7,5,3,3,90,37,53
0,0,0,0,0,0,0,0,0,0
13546,147,132,102,64,41,33,1614,519,1095
0,0,0,0,0,0,0,0,0,0
13578,4,4,3,3,3,0,60,17,43
13580,6,6,1,2,2,1,60,18,42
13588,2,3,2,2,1,2,54,12,42
13591,5,4,2,0,0,0,54,11,43
0,0,0,0,0,0,0,0,0,0
0,0,0,0,0,0,0,0,0,0
0,0,0,0,0,0,0,0,0,0
0,0,0,0,0,0,0,0,0,0
13640,4,6,5,3,2,1,72,21,51
13642,17,12,13,11,5,4,168,62,106
13643,7,5,4,2,1,2,84,21,63
13644,5,8,7,5,3,2,78,30,48
0,0,0,0,0,0,0,0,0,0
13655,5,4,5,4,2,1,72,21,51
13656,16,13,9,10,5,5,138,58,80
13658,10,7,9,4,4,2,96,36,60
13659,11,11,10,4,4,1,144,41,103
13660,194,157,98,63,45,47,2052,604,1448
13681,12,9,6,4,4,1,108,36,72
13684,3,3,3,2,1,1,54,13,41
0,0,0,0,0,0,0,0,0,0
0,0,0,0,0,0,0,0,0,0
13691,2,5,2,2,2,1,72,14,58
13695,18,15,11,6,6,3,156,59,97
13698,9,13,9,5,3,3,114,42,72
0,0,0,0,0,0,0,0,0,0
0,0,0,0,0,0,0,0,0,0
0,0,0,0,0,0,0,0,0,0
0,0,0,0,0,0,0,0,0,0
13718,9,8,5,2,2,1,90,27,63
13719,12,11,6,5,4,1,120,39,81
13733,7,5,3,2,1,1,72,19,53
13738,499,356,263,177,130,79,5328,1504,3824
13765,21,16,6,6,1,3,150,53,97
13766,9,8,6,3,4,4,90,34,56
13770,3,1,1,0,0,0,42,5,37
0,0,0,0,0,0,0,0,0,0
13789,1098,946,651,471,301,180,11826,3647,8179
0,0,0,0,0,0,0,0,0,0
0,0,0,0,0,0,0,0,0,0
13806,1,3,1,2,0,1,48,8,40
13807,8,8,6,6,1,2,96,31,65
0,0,0,0,0,0,0,0,0,0
0,0,0,0,0,0,0,0,0,0
13830,4,5,3,2,3,1,48,18,30
13831,10,7,5,6,2,2,114,32,82
13832,11,5,3,2,1,1,102,23,79
13833,9,8,4,4,2,3,108,30,78
13834,5,4,2,1,0,2,66,14,52
13836,11,9,4,4,2,1,108,31,77
13838,10,9,4,4,2,2,96,31,65
13839,19,10,10,8,3,1,162,51,111
13842,181,134,91,67,32,30,1932,535,1397
0,0,0,0,0,0,0,0,0,0
0,0,0,0,0,0,0,0,0,0
13874,11,10,6,4,2,1,114,34,80
13875,11,10,6,4,2,1,114,34,80
0,0,0,0,0,0,0,0,0,0
0,0,0,0,0,0,0,0,0,0
13888,1,1,0,0,0,0,18,2,16
13889,5,5,4,3,0,2,60,19,41
13890,3,1,2,2,1,1,48,10,38
13912,5,4,2,3,2,1,66,17,49
13913,8,6,6,2,2,0,84,24,60
0,0,0,0,0,0,0,0,0,0
0,0,0,0,0,0,0,0,0,0
13923,137,101,73,50,32,26,1410,419,991
13925,20,12,12,8,4,6,186,62,124
13927,7,5,5,1,1,0,84,19,65
13928,12,8,7,7,7,2,114,43,71
0,0,0,0,0,0,0,0,0,0
13944,227,225,169,121,81,55,2514,878,1636
13946,12,10,8,9,7,3,102,49,53
13947,12,10,8,9,7,3,102,49,53
13954,14,12,9,7,6,2,162,50,112
13956,12,8,5,2,5,0,96,32,64
13957,5,4,3,2,1,0,72,15,57
0,0,0,0,0,0,0,0,0,0
13965,7,4,3,2,3,1,78,20,58
13968,6,7,4,3,3,2,60,25,35
13969,10,7,8,5,2,4,108,36,72
0,0,0,0,0,0,0,0,0,0
0,0,0,0,0,0,0,0,0,0
13975,11,13,7,6,2,7,138,46,92
13977,12,13,5,3,2,0,108,35,73
13979,10,9,8,7,3,3,126,40,86
13980,14,16,9,6,4,1,126,50,76
14007,879,736,477,332,198,139,9456,2761,6695
14013,574,521,354,298,211,112,6882,2070,4812
0,0,0,0,0,0,0,0,0,0
0,0,0,0,0,0,0,0,0,0
14023,3,2,2,2,0,0,30,9,21
14038,212,207,134,100,66,53,2412,772,1640
14040,5,3,3,3,0,2,84,16,68
14042,11,11,10,8,5,2,162,47,115
0,0,0,0,0,0,0,0,0,0
0,0,0,0,0,0,0,0,0,0
0,0,0,0,0,0,0,0,0,0
14054,9,5,8,3,2,0,102,27,75
14056,5,2,3,1,0,0,60,11,49
14067,9,8,6,3,3,2,90,31,59
0,0,0,0,0,0,0,0,0,0
14075,7,8,7,6,4,1,90,33,57
14076,7,8,7,6,4,1,90,33,57
14077,11,8,7,8,5,1,120,40,80
14078,8,7,5,5,4,3,84,32,52
14081,6,6,6,2,2,0,126,22,104
14082,206,167,138,91,71,36,2592,709,1883
0,0,0,0,0,0,0,0,0,0
0,0,0,0,0,0,0,0,0,0
14092,238,179,124,76,54,35,2484,706,1778
14112,10,11,9,7,1,1,114,39,75
14113,15,13,8,4,2,5,138,47,91
14117,8,6,6,2,3,1,96,26,70
0,0,0,0,0,0,0,0,0,0
0,0,0,0,0,0,0,0,0,0
14129,2,2,1,1,2,0,36,8,28
14147,4,7,1,2,0,0,66,14,52
14149,7,6,3,4,1,2,78,23,55
14151,6,7,3,3,3,1,72,23,49
14153,8,7,4,3,1,0,78,23,55
14154,2,1,3,2,0,2,42,10,32
0,0,0,0,0,0,0,0,0,0
14172,64,58,46,36,20,13,792,237,555
0,0,0,0,0,0,0,0,0,0
14182,7,6,4,4,4,1,78,26,52
14184,20,16,9,9,4,2,168,60,108
0,0,0,0,0,0,0,0,0,0
14186,20,16,9,9,4,2,168,60,108
14197,4,6,4,4,0,4,66,22,44
14198,4,3,3,1,1,0,54,12,42
0,0,0,0,0,0,0,0,0,0
0,0,0,0,0,0,0,0,0,0
0,0,0,0,0,0,0,0,0,0
14234,6,5,3,3,3,1,78,21,57
14236,18,15,9,6,4,2,150,54,96
14238,4,4,4,2,1,1,66,16,50
14239,4,4,4,2,1,1,66,16,50
0,0,0,0,0,0,0,0,0,0
0,0,0,0,0,0,0,0,0,0
14254,9,10,8,8,5,1,126,41,85
14255,2,4,4,1,2,2,60,15,45
14256,6,4,2,3,1,1,102,17,85
0,0,0,0,0,0,0,0,0,0
14260,81,67,36,32,16,18,1074,250,824
0,0,0,0,0,0,0,0,0,0
0,0,0,0,0,0,0,0,0,0
14268,3,3,2,1,0,0,36,9,27
0,0,0,0,0,0,0,0,0,0
0,0,0,0,0,0,0,0,0,0
14296,11,7,2,2,0,1,90,23,67
14297,144,101,67,43,20,23,1854,398,1456
14299,2,2,2,1,0,1,30,8,22
14301,0,1,0,0,1,0,12,2,10
0,0,0,0,0,0,0,0,0,0
0,0,0,0,0,0,0,0,0,0
14314,10,7,8,7,5,3,96,40,56
14318,12,11,8,3,3,1,132,38,94
14319,8,5,3,1,0,3,90,20,70
14320,5,4,7,4,2,1,72,23,49
14341,10,9,5,6,2,2,108,34,74
14342,6,6,7,1,0,2,72,22,50
0,0,0,0,0,0,0,0,0,0
0,0,0,0,0,0,0,0,0,0
0,0,0,0,0,0,0,0,0,0
14350,16,8,6,7,3,4,132,44,88
14353,12,9,5,4,3,0,138,33,105
14354,9,6,3,3,4,0,78,25,53
14355,8,7,5,6,4,4,120,34,86
14359,208,157,95,50,28,19,2328,557,1771
0,0,0,0,0,0,0,0,0,0
0,0,0,0,0,0,0,0,0,0
0,0,0,0,0,0,0,0,0,0
14371,13,15,5,6,1,4,138,44,94
14374,2,5,5,5,2,1,66,20,46
14381,7,7,4,3,1,1,90,23,67
0,0,0,0,0,0,0,0,0,0
14402,4,3,3,2,3,1,36,16,20
14403,2,3,2,1,0,1,78,9,69
0,0,0,0,0,0,0,0,0,0
0,0,0,0,0,0,0,0,0,0
14408,286,242,156,90,54,30,2970,858,2112
0,0,0,0,0,0,0,0,0,0
14418,7,8,7,4,3,0,102,29,73
14419,8,10,4,4,3,1,96,30,66
14420,6,10,4,5,4,0,66,29,37
14421,14,9,5,4,1,2,114,35,79
14422,12,11,5,2,2,1,90,33,57
14423,4,5,3,2,2,1,42,17,25
14426,173,155,96,76,40,37,2052,577,1475
0,0,0,0,0,0,0,0,0,0
0,0,0,0,0,0,0,0,0,0
14477,12,7,3,2,0,3,114,27,87
0,0,0,0,0,0,0,0,0,0
0,0,0,0,0,0,0,0,0,0
0,0,0,0,0,0,0,0,0,0
14488,6,4,5,4,0,1,48,20,28
14492,10,6,5,4,0,1,84,26,58
0,0,0,0,0,0,0,0,0,0
0,0,0,0,0,0,0,0,0,0
0,0,0,0,0,0,0,0,0,0
0,0,0,0,0,0,0,0,0,0
0,0,0,0,0,0,0,0,0,0
14568,11,12,8,7,3,2,114,43,71
14569,8,7,5,4,2,1,78,27,51
14570,15,12,7,4,1,2,120,41,79
14571,2,3,4,3,2,2,48,16,32
14573,9,9,6,4,2,1,108,31,77
14575,4,3,3,2,2,3,42,17,25
14576,22,18,11,8,4,1,192,64,128
14577,18,14,8,3,5,2,150,50,100
14589,10,8,8,4,4,3,108,37,71
14590,3,3,4,2,2,1,54,15,39
14591,14,14,11,7,2,3,126,51,75
14597,65,50,37,38,26,4,900,220,680
14603,3,3,2,1,2,0,30,11,19
14605,5,5,3,4,4,0,54,21,33
14623,1192,972,744,521,322,198,13992,3949,10043
0,0,0,0,0,0,0,0,0,0
0,0,0,0,0,0,0,0,0,0
14675,231,150,125,80,59,29,2328,674,1654
14677,7,8,7,5,3,3,78,33,45
14678,2,2,1,0,0,1,36,6,30
14680,4,3,4,2,1,0,54,14,40
14684,6,6,6,5,5,1,84,29,55
0,0,0,0,0,0,0,0,0,0
0,0,0,0,0,0,0,0,0,0
0,0,0,0,0,0,0,0,0,0
14716,14,12,6,5,3,2,162,42,120
14718,9,12,10,5,5,3,108,44,64
0,0,0,0,0,0,0,0,0,0
14729,149,133,109,87,47,16,2004,541,1463
0,0,0,0,0,0,0,0,0,0
14739,15,14,11,7,0,1,168,48,120
14744,102,81,63,49,23,15,1278,333,945
14749,15,15,14,8,5,3,180,60,120
0,0,0,0,0,0,0,0,0,0
14760,10,9,5,5,2,3,96,34,62
14761,10,8,4,2,1,1,114,26,88
14762,9,7,7,4,5,1,84,33,51
14763,10,8,8,4,3,0,96,33,63
0,0,0,0,0,0,0,0,0,0
14789,7,6,4,3,3,1,54,24,30
14790,9,7,4,3,2,2,96,27,69
0,0,0,0,0,0,0,0,0,0
14795,5,4,3,4,1,1,60,18,42
14796,7,3,4,3,1,0,60,18,42
0,0,0,0,0,0,0,0,0,0
14801,5,7,6,5,3,0,90,26,64
0,0,0,0,0,0,0,0,0,0
14804,6,7,7,4,3,2,108,29,79
14811,9,7,4,3,1,2,120,26,94
14814,15,15,10,4,6,2,162,52,110
14815,14,16,12,9,4,2,156,57,99
14818,4,2,2,2,0,1,48,11,37
0,0,0,0,0,0,0,0,0,0
0,0,0,0,0,0,0,0,0,0
14842,234,177,118,96,41,30,2634,696,1938
14844,4,5,3,2,2,1,60,17,43
14845,4,5,1,1,1,1,36,13,23
0,0,0,0,0,0,0,0,0,0
0,0,0,0,0,0,0,0,0,0
14859,47,51,45,28,26,18,816,215,601
0,0,0,0,0,0,0,0,0,0
14865,6,8,3,2,2,3,84,24,60
0,0,0,0,0,0,0,0,0,0
14869,6,8,6,4,2,3,90,29,61
14870,5,3,3,3,2,2,66,18,48
14871,3,4,2,2,0,2,42,13,29
14872,13,10,6,5,2,1,108,37,71
14880,3,2,1,0,3,1,48,10,38
14889,1603,1310,934,689,425,253,18432,5214,13218
0,0,0,0,0,0,0,0,0,0
14898,276,260,173,132,85,60,3204,986,2218
0,0,0,0,0,0,0,0,0,0
14909,10,9,7,9,6,1,108,42,66
14913,15,14,10,8,8,2,132,57,75
0,0,0,0,0,0,0,0,0,0
14931,7,6,3,3,2,1,78,22,56
14932,3,1,1,0,0,0,36,5,31
14934,8,9,5,3,0,2,90,27,63
14935,5,6,4,1,2,1,66,19,47
14937,6,6,5,2,0,0,78,19,59
0,0,0,0,0,0,0,0,0,0
14953,6,3,3,4,2,0,72,18,54
14954,12,11,9,7,4,7,156,50,106
14955,12,11,9,7,4,7,156,50,106
0,0,0,0,0,0,0,0,0,0
14960,144,124,91,62,47,24,1830,492,1338
0,0,0,0,0,0,0,0,0,0
14966,8,7,6,2,2,2,84,27,57
0,0,0,0,0,0,0,0,0,0
0,0,0,0,0,0,0,0,0,0
0,0,0,0,0,0,0,0,0,0
14981,1,2,1,1,1,1,24,7,17
14982,6,5,3,2,0,0,60,16,44
14983,6,5,3,4,3,1,60,22,38
0,0,0,0,0,0,0,0,0,0
0,0,0,0,0,0,0,0,0,0
0,0,0,0,0,0,0,0,0,0
15006,7,8,6,3,3,3,96,30,66
15010,5,4,4,2,2,0,54,17,37
15014,11,10,5,3,1,2,120,32,88
15037,9,10,9,3,3,3,102,37,65
15038,2,2,1,1,1,1,30,8,22
15044,8,12,6,4,4,1,90,35,55
15045,10,7,7,5,4,4,102,37,65
0,0,0,0,0,0,0,0,0,0
15053,227,181,118,82,48,30,2814,686,2128
0,0,0,0,0,0,0,0,0,0
0,0,0,0,0,0,0,0,0,0
0,0,0,0,0,0,0,0,0,0
15086,2,3,3,2,3,1,60,14,46
15093,10,14,10,9,3,3,150,49,101
15094,8,9,5,5,7,2,144,36,108
15095,6,7,4,3,2,0,78,22,56
15100,1554,1197,886,560,390,192,16044,4779,11265
0,0,0,0,0,0,0,0,0,0
0,0,0,0,0,0,0,0,0,0
15121,67,59,31,24,14,13,876,208,668
0,0,0,0,0,0,0,0,0,0
0,0,0,0,0,0,0,0,0,0
15131,14,14,9,6,6,3,192,52,140
15132,14,14,9,6,6,3,192,52,140
15133,4,3,5,3,1,2,54,18,36
15134,10,9,6,4,4,1,132,34,98
15136,11,11,9,9,2,1,120,43,77
0,0,0,0,0,0,0,0,0,0
0,0,0,0,0,0,0,0,0,0
0,0,0,0,0,0,0,0,0,0
15153,5,4,2,4,2,4,54,21,33
15157,8,6,2,5,2,2,72,25,47
15158,113,100,68,45,43,24,1710,393,1317
0,0,0,0,0,0,0,0,0,0
0,0,0,0,0,0,0,0,0,0
15168,2,2,2,1,1,1,30,9,21
0,0,0,0,0,0,0,0,0,0
15173,16,13,13,4,1,2,162,49,113
15174,11,12,16,8,8,1,156,56,100
0,0,0,0,0,0,0,0,0,0
15187,6,6,5,4,3,0,108,24,84
0,0,0,0,0,0,0,0,0,0
15199,188,186,130,103,60,52,2382,719,1663
15220,11,12,8,7,5,4,120,47,73
15222,4,2,3,1,1,2,48,13,35
15225,14,8,10,8,5,5,132,50,82
15226,13,13,10,9,7,0,174,52,122
